#,date,home_team,away_team,home_score,away_score,tournament,country,home,margin
1,7/22/2018,Liberia,Sierra Leone,0,0,Friendly,Liberia,1,0
2,7/25/2018,Sint Maarten,British Virgin Islands,2,3,Friendly,Sint Maarten,1,-1
3,7/27/2018,Saint Barthelemy,Anguilla,1,2,Friendly,Saint Barthelemy,1,-1
4,7/27/2018,British Virgin Islands,Saint Martin,0,0,Friendly,Saint Barthelemy,0,0
5,7/28/2018,Saint Martin,Anguilla,5,1,Friendly,Saint Barthelemy,0,4
6,7/28/2018,Saint Barthelemy,British Virgin Islands,3,4,Friendly,Saint Barthelemy,1,-1
7,8/4/2018,Palestine,Iraq,0,3,Friendly,Palestine,1,-3
8,8/4/2018,Belize,Barbados,1,0,Friendly,Belize,1,1
9,8/11/2018,Guadeloupe,Dominica,0,0,Friendly,Guadeloupe,1,0
10,8/15/2018,Guatemala,Cuba,3,0,Friendly,Guatemala,1,3
11,8/17/2018,Grenada,Jamaica,1,5,Friendly,Grenada,1,-4
12,8/18/2018,Andorra,United Arab Emirates,0,0,Friendly,Austria,0,0
13,8/18/2018,Guatemala,Cuba,1,0,Friendly,Guatemala,1,1
14,8/18/2018,French Guiana,Suriname,0,4,Friendly,French Guiana,1,-4
15,8/19/2018,Afghanistan,Palestine,0,0,Friendly,Afghanistan,1,0
16,8/20/2018,Barbados,Jamaica,2,2,Friendly,Barbados,1,0
17,8/22/2018,Sint Maarten,Anguilla,1,1,Friendly,Sint Maarten,1,0
18,8/26/2018,Lesotho,Eswatini,1,0,Friendly,Lesotho,1,1
19,8/26/2018,Barbados,Cuba,0,0,Friendly,Barbados,1,0
20,8/26/2018,Anguilla,Saint Martin,1,2,Friendly,Anguilla,1,-1
21,8/27/2018,Lesotho,Eswatini,2,0,Friendly,Lesotho,1,2
22,8/29/2018,Macao,Solomon Islands,1,4,Friendly,Macao,1,-3
23,8/29/2018,Bangladesh,Sri Lanka,0,1,Friendly,Bangladesh,1,-1
24,8/29/2018,Barbados,Cuba,0,2,Friendly,Barbados,1,-2
25,9/1/2018,East Timor,Brunei,3,1,Southeast Asian Champ qual,Malaysia,0,2
26,9/2/2018,Mongolia,Macao,4,1,East Asian Championship qual,Mongolia,1,3
27,9/2/2018,Guam,Northern Mariana Islands,4,0,East Asian Championship qual,Mongolia,0,4
28,9/2/2018,Ethiopia,Burundi,1,1,Friendly,Ethiopia,1,0
29,9/4/2018,Mongolia,Northern Mariana Islands,9,0,East Asian Championship qual,Mongolia,1,9
30,9/4/2018,Macao,Guam,2,0,East Asian Championship qual,Mongolia,0,2
31,9/4/2018,Pakistan,Nepal,2,1,South Asian Championship,Bangladesh,0,1
32,9/4/2018,Bangladesh,Bhutan,2,0,South Asian Championship,Bangladesh,1,2
33,9/5/2018,India,Sri Lanka,2,0,South Asian Championship,Bangladesh,0,2
34,9/5/2018,Fiji,Solomon Islands,1,1,Friendly,Fiji,1,0
35,9/5/2018,Slovakia,Denmark,3,0,Friendly,Slovakia,1,3
36,9/6/2018,Bahrain,Philippines,1,1,Friendly,Bahrain,1,0
37,9/6/2018,Jordan,Lebanon,0,1,Friendly,Jordan,1,-1
38,9/6/2018,Mongolia,Guam,1,1,East Asian Championship qual,Mongolia,1,0
39,9/6/2018,Macao,Northern Mariana Islands,1,1,East Asian Championship qual,Mongolia,0,0
40,9/6/2018,Uzbekistan,Syria,1,1,Friendly,Uzbekistan,1,0
41,9/6/2018,Bangladesh,Pakistan,1,0,South Asian Championship,Bangladesh,1,1
42,9/6/2018,Kyrgyzstan,Palestine,1,1,Friendly,Kyrgyzstan,1,0
43,9/6/2018,Trinidad and Tobago,United Arab Emirates,2,0,Friendly,Spain,0,2
44,9/6/2018,Nepal,Bhutan,4,0,South Asian Championship,Bangladesh,0,4
45,9/6/2018,Guyana,Barbados,2,2,CONCACAF Nations League q,Guyana,1,0
46,9/6/2018,Dominica,Suriname,0,0,CONCACAF Nations League q,Guadeloupe,0,0
47,9/6/2018,Netherlands,Peru,2,1,Friendly,Netherlands,1,1
48,9/6/2018,Wales,Ireland,4,1,European Nations League B,Wales,1,3
49,9/6/2018,Austria,Sweden,2,0,Friendly,Austria,1,2
50,9/6/2018,Germany,France,0,0,European Nations League A,Germany,1,0
51,9/6/2018,Norway,Cyprus,2,0,European Nations League C,Norway,1,2
52,9/6/2018,Portugal,Croatia,1,1,Friendly,Portugal,1,0
53,9/6/2018,Latvia,Andorra,0,0,European Nations League D,Latvia,1,0
54,9/6/2018,Slovenia,Bulgaria,1,2,European Nations League C,Slovenia,1,-1
55,9/6/2018,Czechia,Ukraine,1,2,European Nations League B,Czechia,1,-1
56,9/6/2018,Armenia,Liechtenstein,2,1,European Nations League D,Armenia,1,1
57,9/6/2018,Kazakhstan,Georgia,0,2,European Nations League D,Kazakhstan,1,-2
58,9/6/2018,Gibraltar,Macedonia,0,2,European Nations League D,Gibraltar,1,-2
59,9/7/2018,Qatar,China,1,0,Friendly,Qatar,1,1
60,9/7/2018,South Korea,Costa Rica,2,0,Friendly,South Korea,1,2
61,9/7/2018,Taiwan,Malaysia,2,0,Friendly,Taiwan,1,2
62,9/7/2018,Maldives,Sri Lanka,0,0,South Asian Championship,Bangladesh,0,0
63,9/7/2018,Singapore,Mauritius,1,1,Friendly,Singapore,1,0
64,9/7/2018,United States,Brazil,0,2,Friendly,United States,1,-2
65,9/7/2018,Argentina,Guatemala,3,0,Friendly,United States,0,3
66,9/7/2018,Uruguay,Mexico,4,1,Friendly,United States,0,3
67,9/7/2018,Ecuador,Jamaica,2,0,Friendly,United States,0,2
68,9/7/2018,Anguilla,French Guiana,0,5,CONCACAF Nations League q,Anguilla,1,-5
69,9/7/2018,Antigua and Barbuda,Saint Lucia,0,3,CONCACAF Nations League q,Antigua and Barbuda,1,-3
70,9/7/2018,Belize,Bahamas,4,0,CONCACAF Nations League q,Belize,1,4
71,9/7/2018,Colombia,Venezuela,2,1,Friendly,United States,0,1
72,9/7/2018,Scotland,Belgium,0,4,Friendly,Scotland,1,-4
73,9/7/2018,Italy,Poland,1,1,European Nations League A,Italy,1,0
74,9/7/2018,Turkey,Russia,1,2,European Nations League B,Turkey,1,-1
75,9/7/2018,Romania,Montenegro,0,0,European Nations League C,Romania,1,0
76,9/7/2018,Lithuania,Serbia,0,1,European Nations League C,Lithuania,1,-1
77,9/7/2018,Albania,Israel,1,0,European Nations League C,Albania,1,1
78,9/7/2018,Faroe Islands,Malta,3,1,European Nations League D,Faroe Islands,1,2
79,9/7/2018,Azerbaijan,Kosovo,0,0,European Nations League D,Azerbaijan,1,0
80,9/8/2018,Pakistan,Bhutan,3,0,South Asian Championship,Bangladesh,0,3
81,9/8/2018,Brunei,East Timor,1,0,Southeast Asian Champ qual,Brunei,1,1
82,9/8/2018,Bangladesh,Nepal,0,2,South Asian Championship,Bangladesh,1,-2
83,9/8/2018,Egypt,Niger,6,0,African Nations Cup qualifier,Egypt,1,6
84,9/8/2018,South Africa,Libya,0,0,African Nations Cup qualifier,South Africa,1,0
85,9/8/2018,Kenya,Ghana,1,0,African Nations Cup qualifier,Kenya,1,1
86,9/8/2018,Uganda,Tanzania,0,0,African Nations Cup qualifier,Uganda,1,0
87,9/8/2018,Namibia,Zambia,1,1,African Nations Cup qualifier,Namibia,1,0
88,9/8/2018,Seychelles,Nigeria,0,3,African Nations Cup qualifier,Seychelles,1,-3
89,9/8/2018,Gambia,Algeria,1,1,African Nations Cup qualifier,The Gambia,0,0
90,9/8/2018,Mozambique,Guinea-Bissau,2,2,African Nations Cup qualifier,Mozambique,1,0
91,9/8/2018,Gabon,Burundi,1,1,African Nations Cup qualifier,Gabon,1,0
92,9/8/2018,Equatorial Guinea,Sudan,1,0,African Nations Cup qualifier,Equatorial Guinea,1,1
93,9/8/2018,Morocco,Malawi,3,0,African Nations Cup qualifier,Morocco,1,3
94,9/8/2018,Comoros,Cameroon,1,1,African Nations Cup qualifier,Comoros,1,0
95,9/8/2018,Mauritania,Burkina Faso,2,0,African Nations Cup qualifier,Mauritania,1,2
96,9/8/2018,Montserrat,El Salvador,1,2,CONCACAF Nations League q,Montserrat,1,-1
97,9/8/2018,St Vincent & Grenadines,Nicaragua,0,2,CONCACAF Nations League q,St Vincent & Grenadines,1,-2
98,9/8/2018,Cuba,Turks and Caicos Islands,11,0,CONCACAF Nations League q,Cuba,1,11
99,9/8/2018,England,Spain,1,2,European Nations League A,England,1,-1
100,9/8/2018,Northern Ireland,Bosnia and Herzegovina,1,2,European Nations League B,Northern Ireland,1,-1
101,9/8/2018,Finland,Hungary,1,0,European Nations League C,Finland,1,1
102,9/8/2018,Switzerland,Iceland,6,0,European Nations League A,Switzerland,1,6
103,9/8/2018,Luxembourg,Moldova,4,0,European Nations League D,Luxembourg,1,4
104,9/8/2018,Estonia,Greece,0,1,European Nations League C,Estonia,1,-1
105,9/8/2018,Belarus,San Marino,5,0,European Nations League D,Belarus,1,5
106,9/9/2018,India,Maldives,2,0,South Asian Championship,Bangladesh,0,2
107,9/9/2018,Lebanon,Oman,0,0,Friendly,Jordan,0,0
108,9/9/2018,Congo,Zimbabwe,1,1,African Nations Cup qualifier,Congo,1,0
109,9/9/2018,Madagascar,Senegal,2,2,African Nations Cup qualifier,Madagascar,1,0
110,9/9/2018,Ethiopia,Sierra Leone,1,0,African Nations Cup qualifier,Ethiopia,1,1
111,9/9/2018,Liberia,DR Congo,1,1,African Nations Cup qualifier,Liberia,1,0
112,9/9/2018,Togo,Benin,0,0,African Nations Cup qualifier,Togo,1,0
113,9/9/2018,Eswatini,Tunisia,0,2,African Nations Cup qualifier,Eswatini,1,-2
114,9/9/2018,Lesotho,Cape Verde,1,1,African Nations Cup qualifier,Lesotho,1,0
115,9/9/2018,Guinea,Central African Republic,1,0,African Nations Cup qualifier,Guinea,1,1
116,9/9/2018,South Sudan,Mali,0,3,African Nations Cup qualifier,South Sudan,1,-3
117,9/9/2018,Rwanda,Ivory Coast,1,2,African Nations Cup qualifier,Rwanda,1,-1
118,9/9/2018,Angola,Botswana,1,0,African Nations Cup qualifier,Angola,1,1
119,9/9/2018,Canada,US Virgin Islands,8,0,CONCACAF Nations League q,United States,0,8
120,9/9/2018,Aruba,Bermuda,3,1,CONCACAF Nations League q,Curaçao,0,2
121,9/9/2018,Jamaica,Cayman Islands,4,0,CONCACAF Nations League q,Jamaica,1,4
122,9/9/2018,Saint Kitts and Nevis,Puerto Rico,1,0,CONCACAF Nations League q,Saint Kitts and Nevis,1,1
123,9/9/2018,Dominican Republic,Bonaire,5,0,CONCACAF Nations League q,Curaçao,0,5
124,9/9/2018,Germany,Peru,2,1,Friendly,Germany,1,1
125,9/9/2018,Denmark,Wales,2,0,European Nations League B,Denmark,1,2
126,9/9/2018,France,Netherlands,2,1,European Nations League A,France,1,1
127,9/9/2018,Bulgaria,Norway,1,0,European Nations League C,Bulgaria,1,1
128,9/9/2018,Georgia,Latvia,1,0,European Nations League D,Georgia,1,1
129,9/9/2018,Ukraine,Slovakia,1,0,European Nations League B,Ukraine,1,1
130,9/9/2018,Cyprus,Slovenia,2,1,European Nations League C,Cyprus,1,1
131,9/9/2018,Macedonia,Armenia,2,0,European Nations League D,Macedonia,1,2
132,9/9/2018,Liechtenstein,Gibraltar,2,0,European Nations League D,Liechtenstein,1,2
133,9/10/2018,Bahrain,China,0,0,Friendly,Bahrain,1,0
134,9/10/2018,Kyrgyzstan,Syria,2,1,Friendly,Kyrgyzstan,1,1
135,9/10/2018,Cambodia,Malaysia,1,3,Friendly,Cambodia,1,-2
136,9/10/2018,Kuwait,Iraq,2,2,Friendly,Kuwait,1,0
137,9/10/2018,Saudi Arabia,Bolivia,2,2,Friendly,Saudi Arabia,1,0
138,9/10/2018,Curaçao,Grenada,10,0,CONCACAF Nations League q,Curaçao,1,10
139,9/10/2018,Haiti,Sint Maarten,13,0,CONCACAF Nations League q,Haiti,1,13
140,9/10/2018,Scotland,Albania,2,0,European Nations League C,Scotland,1,2
141,9/10/2018,Sweden,Turkey,2,3,European Nations League B,Sweden,1,-1
142,9/10/2018,Portugal,Italy,1,0,European Nations League A,Portugal,1,1
143,9/10/2018,Russia,Czechia,5,1,Friendly,Russia,1,4
144,9/10/2018,Serbia,Romania,2,2,European Nations League C,Serbia,1,0
145,9/10/2018,Montenegro,Lithuania,2,0,European Nations League C,Montenegro,1,2
146,9/10/2018,Malta,Azerbaijan,1,1,European Nations League D,Malta,1,0
147,9/10/2018,Kosovo,Faroe Islands,2,0,European Nations League D,Kosovo,1,2
148,9/10/2018,Andorra,Kazakhstan,1,1,European Nations League D,Andorra,1,0
149,9/11/2018,Japan,Costa Rica,3,0,Friendly,Japan,1,3
150,9/11/2018,Indonesia,Mauritius,1,0,Friendly,Indonesia,1,1
151,9/11/2018,Uzbekistan,Iran,0,1,Friendly,Uzbekistan,1,-1
152,9/11/2018,South Korea,Chile,0,0,Friendly,South Korea,1,0
153,9/11/2018,Singapore,Fiji,2,0,Friendly,Singapore,1,2
154,9/11/2018,Jordan,Oman,0,0,Friendly,Jordan,1,0
155,9/11/2018,United Arab Emirates,Laos,3,0,Friendly,Spain,0,3
156,9/11/2018,Qatar,Palestine,3,0,Friendly,Qatar,1,3
157,9/11/2018,Kenya,Malawi,1,0,Friendly,Kenya,1,1
158,9/11/2018,Gabon,Zambia,0,1,Friendly,Gabon,1,-1
159,9/11/2018,Liberia,Nigeria,1,2,Friendly,Liberia,1,-1
160,9/11/2018,United States,Mexico,1,0,Friendly,United States,1,1
161,9/11/2018,Brazil,El Salvador,5,0,Friendly,United States,0,5
162,9/11/2018,Ecuador,Guatemala,2,0,Friendly,United States,0,2
163,9/11/2018,Guadeloupe,Saint Martin,3,0,CONCACAF Nations League q,Anguilla,0,3
164,9/11/2018,Panama,Venezuela,0,2,Friendly,Panama,1,-2
165,9/11/2018,Argentina,Colombia,0,0,Friendly,United States,0,0
166,9/11/2018,England,Switzerland,1,0,Friendly,England,1,1
167,9/11/2018,Northern Ireland,Israel,3,0,Friendly,Northern Ireland,1,3
168,9/11/2018,Bosnia and Herzegovina,Austria,1,0,European Nations League B,Bosnia and Herzegovina,1,1
169,9/11/2018,Hungary,Greece,2,1,European Nations League C,Hungary,1,1
170,9/11/2018,Iceland,Belgium,0,3,European Nations League A,Iceland,1,-3
171,9/11/2018,Finland,Estonia,1,0,European Nations League C,Finland,1,1
172,9/11/2018,San Marino,Luxembourg,0,3,European Nations League D,San Marino,1,-3
173,9/11/2018,Poland,Ireland,1,1,Friendly,Poland,1,0
174,9/11/2018,Spain,Croatia,6,0,European Nations League A,Spain,1,6
175,9/11/2018,Moldova,Belarus,0,0,European Nations League D,Moldova,1,0
176,9/12/2018,India,Pakistan,3,1,South Asian Championship,Bangladesh,0,2
177,9/12/2018,Maldives,Nepal,3,0,South Asian Championship,Bangladesh,0,3
178,9/15/2018,Maldives,India,2,1,South Asian Championship,Bangladesh,0,1
179,9/29/2018,Cuba,Cayman Islands,5,0,Friendly,Cuba,1,5
180,9/30/2018,Botswana,Namibia,1,0,Friendly,Botswana,1,1
181,9/30/2018,St Vincent & Grenadines,Barbados,1,1,Friendly,St Vincent & Grenadines,1,0
182,10/1/2018,Bangladesh,Laos,1,0,Bangabandhu Gold Cup,Bangladesh,1,1
183,10/2/2018,Tajikistan,Nepal,2,0,Bangabandhu Gold Cup,Bangladesh,0,2
184,10/3/2018,Philippines,Laos,3,1,Bangabandhu Gold Cup,Bangladesh,0,2
185,10/4/2018,Palestine,Tajikistan,2,0,Bangabandhu Gold Cup,Bangladesh,0,2
186,10/5/2018,Bangladesh,Philippines,0,1,Bangabandhu Gold Cup,Bangladesh,1,-1
187,10/6/2018,Palestine,Nepal,1,0,Bangabandhu Gold Cup,Bangladesh,0,1
188,10/9/2018,Tajikistan,Philippines,2,0,Bangabandhu Gold Cup,Bangladesh,0,2
189,10/10/2018,Indonesia,Myanmar,3,0,Friendly,Indonesia,1,3
190,10/10/2018,Albania,Jordan,0,0,Friendly,Albania,1,0
191,10/10/2018,Bangladesh,Palestine,0,2,Bangabandhu Gold Cup,Bangladesh,1,-2
192,10/10/2018,Ethiopia,Kenya,0,0,African Nations Cup qualifier,Ethiopia,1,0
193,10/10/2018,Zambia,Guinea-Bissau,2,1,African Nations Cup qualifier,Zambia,1,1
194,10/10/2018,Italy,Ukraine,1,1,Friendly,Italy,1,0
195,10/11/2018,Kuwait,Lebanon,1,0,Friendly,Kuwait,1,1
196,10/11/2018,Bahrain,Syria,0,1,Friendly,Bahrain,1,-1
197,10/11/2018,Hong Kong,Thailand,0,1,Friendly,Hong Kong,1,-1
198,10/11/2018,Argentina,Iraq,4,0,Friendly tournament,Saudi Arabia,0,4
199,10/11/2018,Honduras,United Arab Emirates,1,1,Friendly,Spain,0,0
200,10/11/2018,Congo,Liberia,3,1,African Nations Cup qualifier,Congo,1,2
201,10/11/2018,United States,Colombia,2,4,Friendly,United States,1,-2
202,10/11/2018,Mexico,Costa Rica,3,2,Friendly,Mexico,1,1
203,10/11/2018,French Guiana,St Vincent & Grenadines,0,1,CONCACAF Nations League q,French Guiana,1,-1
204,10/11/2018,Israel,Scotland,2,1,European Nations League C,Israel,1,1
205,10/11/2018,Wales,Spain,1,4,Friendly,Wales,1,-3
206,10/11/2018,France,Iceland,2,2,Friendly,France,1,0
207,10/11/2018,Russia,Sweden,0,0,European Nations League B,Russia,1,0
208,10/11/2018,Poland,Portugal,2,3,European Nations League A,Poland,1,-1
209,10/11/2018,Lithuania,Romania,1,2,European Nations League C,Lithuania,1,-1
210,10/11/2018,Turkey,Bosnia and Herzegovina,0,0,Friendly,Turkey,1,0
211,10/11/2018,Montenegro,Serbia,0,2,European Nations League C,Montenegro,1,-2
212,10/11/2018,Kosovo,Malta,3,1,European Nations League D,Kosovo,1,2
213,10/11/2018,Faroe Islands,Azerbaijan,0,3,European Nations League D,Faroe Islands,1,-3
214,10/12/2018,Japan,Panama,3,0,Friendly,Japan,1,3
215,10/12/2018,Singapore,Mongolia,2,0,Friendly,Singapore,1,2
216,10/12/2018,South Korea,Uruguay,2,1,Friendly,South Korea,1,1
217,10/12/2018,Sri Lanka,Malaysia,1,4,Friendly,Sri Lanka,1,-3
218,10/12/2018,Cambodia,East Timor,2,2,Friendly,Cambodia,1,0
219,10/12/2018,Saudi Arabia,Brazil,0,2,Friendly tournament,Saudi Arabia,1,-2
220,10/12/2018,Palestine,Tajikistan,0,0,Bangabandhu Gold Cup,Bangladesh,0,0
221,10/12/2018,Qatar,Ecuador,4,3,Friendly,Qatar,1,1
222,10/12/2018,Egypt,Eswatini,4,1,African Nations Cup qualifier,Egypt,1,3
223,10/12/2018,Cape Verde,Tanzania,3,0,African Nations Cup qualifier,Cape Verde,1,3
224,10/12/2018,Togo,Gambia,1,1,African Nations Cup qualifier,Togo,1,0
225,10/12/2018,Mali,Burundi,0,0,African Nations Cup qualifier,Mali,1,0
226,10/12/2018,Cameroon,Malawi,1,0,African Nations Cup qualifier,Cameroon,1,1
227,10/12/2018,Algeria,Benin,2,0,African Nations Cup qualifier,Algeria,1,2
228,10/12/2018,Ivory Coast,Central African Republic,4,0,African Nations Cup qualifier,Ivory Coast,1,4
229,10/12/2018,Gabon,South Sudan,3,0,African Nations Cup qualifier,Gabon,1,3
230,10/12/2018,Guinea,Rwanda,2,0,African Nations Cup qualifier,Guinea,1,2
231,10/12/2018,Angola,Mauritania,4,1,African Nations Cup qualifier,Angola,1,3
232,10/12/2018,Curaçao,US Virgin Islands,5,0,CONCACAF Nations League q,United States,0,5
233,10/12/2018,Grenada,Cuba,0,2,CONCACAF Nations League q,Grenada,1,-2
234,10/12/2018,Dominican Republic,Cayman Islands,3,0,CONCACAF Nations League q,Dominican Republic,1,3
235,10/12/2018,Bermuda,Sint Maarten,12,0,CONCACAF Nations League q,Bermuda,1,12
236,10/12/2018,Bahamas,Antigua and Barbuda,0,6,CONCACAF Nations League q,Bahamas,1,-6
237,10/12/2018,Peru,Chile,3,0,Friendly,United States,0,3
238,10/12/2018,Croatia,England,0,0,European Nations League A,Croatia,1,0
239,10/12/2018,Austria,Northern Ireland,1,0,European Nations League B,Austria,1,1
240,10/12/2018,Greece,Hungary,1,0,European Nations League C,Greece,1,1
241,10/12/2018,Belgium,Switzerland,2,1,European Nations League A,Belgium,1,1
242,10/12/2018,Estonia,Finland,0,1,European Nations League C,Estonia,1,-1
243,10/12/2018,Belarus,Luxembourg,1,0,European Nations League D,Belarus,1,1
244,10/12/2018,Moldova,San Marino,2,0,European Nations League D,Moldova,1,2
245,10/13/2018,Oman,Philippines,1,1,Friendly,Qatar,0,0
246,10/13/2018,China,India,0,0,Friendly,China,1,0
247,10/13/2018,Myanmar,Bolivia,0,3,Friendly,Myanmar,1,-3
248,10/13/2018,Uzbekistan,North Korea,2,0,Friendly,Uzbekistan,1,2
249,10/13/2018,South Africa,Seychelles,6,0,African Nations Cup qualifier,South Africa,1,6
250,10/13/2018,Uganda,Lesotho,3,0,African Nations Cup qualifier,Uganda,1,3
251,10/13/2018,DR Congo,Zimbabwe,1,2,African Nations Cup qualifier,DR Congo,1,-1
252,10/13/2018,Equatorial Guinea,Madagascar,0,1,African Nations Cup qualifier,Equatorial Guinea,1,-1
253,10/13/2018,Nigeria,Libya,4,0,African Nations Cup qualifier,Nigeria,1,4
254,10/13/2018,Senegal,Sudan,3,0,African Nations Cup qualifier,Senegal,1,3
255,10/13/2018,Tunisia,Niger,1,0,African Nations Cup qualifier,Tunisia,1,1
256,10/13/2018,Morocco,Comoros,1,0,African Nations Cup qualifier,Morocco,1,1
257,10/13/2018,Burkina Faso,Botswana,3,0,African Nations Cup qualifier,Burkina Faso,1,3
258,10/13/2018,Mozambique,Namibia,1,2,African Nations Cup qualifier,Mozambique,1,-1
259,10/13/2018,El Salvador,Barbados,3,0,CONCACAF Nations League q,El Salvador,1,3
260,10/13/2018,Turks and Caicos Islands,Guyana,0,8,CONCACAF Nations League q,Turks and Caicos Islands,1,-8
261,10/13/2018,Puerto Rico,Martinique,0,1,CONCACAF Nations League q,Puerto Rico,1,-1
262,10/13/2018,Suriname,British Virgin Islands,5,0,CONCACAF Nations League q,Suriname,1,5
263,10/13/2018,Netherlands,Germany,3,0,European Nations League A,Netherlands,1,3
264,10/13/2018,Norway,Slovenia,1,0,European Nations League C,Norway,1,1
265,10/13/2018,Ireland,Denmark,0,0,European Nations League B,Ireland,1,0
266,10/13/2018,Latvia,Kazakhstan,1,1,European Nations League D,Latvia,1,0
267,10/13/2018,Bulgaria,Cyprus,2,1,European Nations League C,Bulgaria,1,1
268,10/13/2018,Slovakia,Czechia,1,2,European Nations League B,Slovakia,1,-1
269,10/13/2018,Armenia,Gibraltar,0,1,European Nations League D,Armenia,1,-1
270,10/13/2018,Georgia,Andorra,3,0,European Nations League D,Georgia,1,3
271,10/13/2018,Macedonia,Liechtenstein,4,1,European Nations League D,Macedonia,1,3
272,10/14/2018,Thailand,Trinidad and Tobago,1,0,Friendly,Thailand,1,1
273,10/14/2018,Kenya,Ethiopia,3,0,African Nations Cup qualifier,Kenya,1,3
274,10/14/2018,Guinea-Bissau,Zambia,2,1,African Nations Cup qualifier,Guinea-Bissau,1,1
275,10/14/2018,Jamaica,Bonaire,6,0,CONCACAF Nations League q,Curaçao,0,6
276,10/14/2018,Nicaragua,Anguilla,6,0,CONCACAF Nations League q,Costa Rica,0,6
277,10/14/2018,Saint Kitts and Nevis,Saint Martin,10,0,CONCACAF Nations League q,Anguilla,0,10
278,10/14/2018,Montserrat,Belize,1,0,CONCACAF Nations League q,Montserrat,1,1
279,10/14/2018,Scotland,Portugal,1,3,Friendly,Scotland,1,-2
280,10/14/2018,Poland,Italy,0,1,European Nations League A,Poland,1,-1
281,10/14/2018,Russia,Turkey,2,0,European Nations League B,Russia,1,2
282,10/14/2018,Romania,Serbia,0,0,European Nations League C,Romania,1,0
283,10/14/2018,Lithuania,Montenegro,1,4,European Nations League C,Lithuania,1,-3
284,10/14/2018,Israel,Albania,2,0,European Nations League C,Israel,1,2
285,10/14/2018,Azerbaijan,Malta,1,1,European Nations League D,Azerbaijan,1,0
286,10/14/2018,Faroe Islands,Kosovo,1,1,European Nations League D,Faroe Islands,1,0
287,10/15/2018,Kuwait,Australia,0,4,Friendly,Kuwait,1,-4
288,10/15/2018,Saudi Arabia,Iraq,1,1,Friendly tournament,Saudi Arabia,1,0
289,10/15/2018,Croatia,Jordan,2,1,Friendly,Croatia,1,1
290,10/15/2018,Spain,England,2,3,European Nations League A,Spain,1,-1
291,10/15/2018,Bosnia and Herzegovina,Northern Ireland,2,0,European Nations League B,Bosnia and Herzegovina,1,2
292,10/15/2018,Estonia,Hungary,3,3,European Nations League C,Estonia,1,0
293,10/15/2018,Iceland,Switzerland,1,2,European Nations League A,Iceland,1,-1
294,10/15/2018,Finland,Greece,2,0,European Nations League C,Finland,1,2
295,10/15/2018,Luxembourg,San Marino,3,0,European Nations League D,Luxembourg,1,3
296,10/15/2018,Belarus,Moldova,0,0,European Nations League D,Belarus,1,0
297,10/16/2018,Japan,Uruguay,4,3,Friendly,Japan,1,1
298,10/16/2018,China,Syria,2,0,Friendly,China,1,2
299,10/16/2018,Indonesia,Hong Kong,1,1,Friendly,Indonesia,1,0
300,10/16/2018,Iran,Bolivia,2,1,Friendly,Iran,1,1
301,10/16/2018,Laos,Mongolia,1,4,Friendly,Laos,1,-3
302,10/16/2018,South Korea,Panama,2,2,Friendly,South Korea,1,0
303,10/16/2018,Bahrain,Myanmar,4,1,Friendly,Bahrain,1,3
304,10/16/2018,Cambodia,Singapore,1,2,Friendly,Cambodia,1,-1
305,10/16/2018,Malaysia,Kyrgyzstan,0,1,Friendly,Malaysia,1,-1
306,10/16/2018,Ecuador,Oman,0,0,Friendly,Qatar,0,0
307,10/16/2018,Uzbekistan,Qatar,2,0,Friendly,Uzbekistan,1,2
308,10/16/2018,Venezuela,United Arab Emirates,2,0,Friendly,Spain,0,2
309,10/16/2018,Eswatini,Egypt,0,2,African Nations Cup qualifier,Eswatini,1,-2
310,10/16/2018,Seychelles,South Africa,0,0,African Nations Cup qualifier,Seychelles,1,0
311,10/16/2018,Lesotho,Uganda,0,2,African Nations Cup qualifier,Lesotho,1,-2
312,10/16/2018,Tanzania,Cape Verde,2,0,African Nations Cup qualifier,Tanzania,1,2
313,10/16/2018,Zimbabwe,DR Congo,1,1,African Nations Cup qualifier,Zimbabwe,1,0
314,10/16/2018,Madagascar,Equatorial Guinea,1,0,African Nations Cup qualifier,Madagascar,1,1
315,10/16/2018,Nigeria,Libya,3,2,African Nations Cup qualifier,Tunisia,0,1
316,10/16/2018,Gambia,Togo,0,1,African Nations Cup qualifier,The Gambia,0,-1
317,10/16/2018,Burundi,Mali,1,1,African Nations Cup qualifier,Burundi,1,0
318,10/16/2018,Sudan,Senegal,0,1,African Nations Cup qualifier,Sudan,1,-1
319,10/16/2018,Niger,Tunisia,1,2,African Nations Cup qualifier,Niger,1,-1
320,10/16/2018,Malawi,Cameroon,0,0,African Nations Cup qualifier,Malawi,1,0
321,10/16/2018,Comoros,Morocco,2,2,African Nations Cup qualifier,Comoros,1,0
322,10/16/2018,Benin,Algeria,1,0,African Nations Cup qualifier,Benin,1,1
323,10/16/2018,Central African Republic,Ivory Coast,0,0,African Nations Cup qualifier,Central African Republic,1,0
324,10/16/2018,South Sudan,Gabon,0,1,African Nations Cup qualifier,South Sudan,1,-1
325,10/16/2018,Botswana,Burkina Faso,0,0,African Nations Cup qualifier,Botswana,1,0
326,10/16/2018,Liberia,Congo,2,1,African Nations Cup qualifier,Liberia,1,1
327,10/16/2018,Rwanda,Guinea,1,1,African Nations Cup qualifier,Rwanda,1,0
328,10/16/2018,Mauritania,Angola,1,0,African Nations Cup qualifier,Mauritania,1,1
329,10/16/2018,Namibia,Mozambique,1,0,African Nations Cup qualifier,Namibia,1,1
330,10/16/2018,United States,Peru,1,1,Friendly,United States,1,0
331,10/16/2018,Canada,Dominica,5,0,CONCACAF Nations League q,Canada,1,5
332,10/16/2018,Colombia,Costa Rica,3,1,Friendly,United States,0,2
333,10/16/2018,Mexico,Chile,0,1,Friendly,Mexico,1,-1
334,10/16/2018,Guadeloupe,Aruba,0,0,CONCACAF Nations League q,Guadeloupe,1,0
335,10/16/2018,Haiti,Saint Lucia,2,1,CONCACAF Nations League q,Martinique,0,1
336,10/16/2018,Martinique,British Virgin Islands,4,0,CONCACAF Nations League q,Martinique,1,4
337,10/16/2018,Brazil,Argentina,1,0,Friendly tournament,Saudi Arabia,0,1
338,10/16/2018,Ireland,Wales,0,1,European Nations League B,Ireland,1,-1
339,10/16/2018,Denmark,Austria,2,0,Friendly,Denmark,1,2
340,10/16/2018,Belgium,Netherlands,1,1,Friendly,Belgium,1,0
341,10/16/2018,France,Germany,2,1,European Nations League A,France,1,1
342,10/16/2018,Sweden,Slovakia,1,1,Friendly,Sweden,1,0
343,10/16/2018,Norway,Bulgaria,1,0,European Nations League C,Norway,1,1
344,10/16/2018,Latvia,Georgia,0,3,European Nations League D,Latvia,1,-3
345,10/16/2018,Ukraine,Czechia,1,0,European Nations League B,Ukraine,1,1
346,10/16/2018,Slovenia,Cyprus,1,1,European Nations League C,Slovenia,1,0
347,10/16/2018,Armenia,Macedonia,4,0,European Nations League D,Armenia,1,4
348,10/16/2018,Kazakhstan,Andorra,4,0,European Nations League D,Kazakhstan,1,4
349,10/16/2018,Gibraltar,Liechtenstein,2,1,European Nations League D,Gibraltar,1,1
350,11/3/2018,Malaysia,Maldives,3,0,Friendly,Malaysia,1,3
351,11/8/2018,Laos,Vietnam,0,3,Southeast Asian Champ,Laos,1,-3
352,11/8/2018,Cambodia,Malaysia,0,1,Southeast Asian Champ,Cambodia,1,-1
353,11/9/2018,Singapore,Indonesia,1,0,Southeast Asian Champ,Singapore,1,1
354,11/9/2018,Thailand,East Timor,7,0,Southeast Asian Champ,Thailand,1,7
355,11/11/2018,North Korea,Mongolia,4,1,East Asian Championship qual,Taiwan,0,3
356,11/11/2018,Taiwan,Hong Kong,1,2,East Asian Championship qual,Taiwan,1,-1
357,11/12/2018,Myanmar,Cambodia,4,1,Southeast Asian Champ,Myanmar,1,3
358,11/12/2018,Malaysia,Laos,3,1,Southeast Asian Champ,Malaysia,1,2
359,11/13/2018,Philippines,Singapore,1,0,Southeast Asian Champ,Philippines,1,1
360,11/13/2018,Indonesia,East Timor,3,1,Southeast Asian Champ,Indonesia,1,2
361,11/13/2018,Taiwan,Mongolia,2,1,East Asian Championship qual,Taiwan,1,1
362,11/13/2018,Hong Kong,North Korea,0,0,East Asian Championship qual,Taiwan,0,0
363,11/14/2018,Switzerland,Qatar,0,1,Friendly,Switzerland,1,-1
364,11/14/2018,Vanuatu,New Caledonia,0,1,Friendly,Vanuatu,1,-1
365,11/15/2018,Lebanon,Uzbekistan,0,0,Friendly,Australia,0,0
366,11/15/2018,Iran,Trinidad and Tobago,1,0,Friendly,Iran,1,1
367,11/15/2018,England,United States,3,0,Friendly,England,1,3
368,11/15/2018,Israel,Guatemala,7,0,Friendly,Israel,1,7
369,11/15/2018,Peru,Ecuador,0,2,Friendly,Peru,1,-2
370,11/15/2018,Ireland,Northern Ireland,0,0,Friendly,Ireland,1,0
371,11/15/2018,Austria,Bosnia and Herzegovina,0,0,European Nations League B,Austria,1,0
372,11/15/2018,Hungary,Estonia,2,0,European Nations League C,Hungary,1,2
373,11/15/2018,Belgium,Iceland,2,0,European Nations League A,Belgium,1,2
374,11/15/2018,Germany,Russia,3,0,Friendly,Germany,1,3
375,11/15/2018,Greece,Finland,1,0,European Nations League C,Greece,1,1
376,11/15/2018,Luxembourg,Belarus,0,2,European Nations League D,Luxembourg,1,-2
377,11/15/2018,Poland,Czechia,0,1,Friendly,Poland,1,-1
378,11/15/2018,Croatia,Spain,3,2,European Nations League A,Croatia,1,1
379,11/15/2018,Kazakhstan,Latvia,1,1,European Nations League D,Kazakhstan,1,0
380,11/15/2018,San Marino,Moldova,0,1,European Nations League D,San Marino,1,-1
381,11/15/2018,Andorra,Georgia,1,1,European Nations League D,Andorra,1,0
382,11/16/2018,Japan,Venezuela,1,1,Friendly,Japan,1,0
383,11/16/2018,Hong Kong,Mongolia,5,1,East Asian Championship qual,Taiwan,0,4
384,11/16/2018,Vietnam,Malaysia,2,0,Southeast Asian Champ,Vietnam,1,2
385,11/16/2018,Oman,Syria,1,1,Friendly,Oman,1,0
386,11/16/2018,Taiwan,North Korea,0,2,East Asian Championship qual,Taiwan,1,-2
387,11/16/2018,Laos,Myanmar,1,3,Southeast Asian Champ,Laos,1,-2
388,11/16/2018,Palestine,Pakistan,2,1,Friendly,Palestine,1,1
389,11/16/2018,Saudi Arabia,Yemen,1,0,Friendly,Saudi Arabia,1,1
390,11/16/2018,United Arab Emirates,Bolivia,0,0,Friendly,United Arab Emirates,1,0
391,11/16/2018,Egypt,Tunisia,3,2,African Nations Cup qualifier,Egypt,1,1
392,11/16/2018,South Sudan,Burundi,2,5,African Nations Cup qualifier,South Sudan,1,-3
393,11/16/2018,Morocco,Cameroon,2,0,African Nations Cup qualifier,Morocco,1,2
394,11/16/2018,Chile,Costa Rica,2,3,Friendly,Chile,1,-1
395,11/16/2018,Bermuda,El Salvador,1,0,CONCACAF Nations League q,Bermuda,1,1
396,11/16/2018,Argentina,Mexico,2,0,Friendly,Argentina,1,2
397,11/16/2018,Aruba,Montserrat,0,2,CONCACAF Nations League q,Curaçao,0,-2
398,11/16/2018,Honduras,Panama,1,0,Friendly,Honduras,1,1
399,11/16/2018,Grenada,Saint Martin,5,2,CONCACAF Nations League q,Grenada,1,3
400,11/16/2018,Belize,Puerto Rico,1,0,CONCACAF Nations League q,Belize,1,1
401,11/16/2018,Brazil,Uruguay,1,0,Friendly,England,0,1
402,11/16/2018,Wales,Denmark,1,2,European Nations League B,Wales,1,-1
403,11/16/2018,Netherlands,France,2,0,European Nations League A,Netherlands,1,2
404,11/16/2018,Slovenia,Norway,1,1,European Nations League C,Slovenia,1,0
405,11/16/2018,Cyprus,Bulgaria,1,1,European Nations League C,Cyprus,1,0
406,11/16/2018,Slovakia,Ukraine,4,1,European Nations League B,Slovakia,1,3
407,11/16/2018,Gibraltar,Armenia,2,6,European Nations League D,Gibraltar,1,-4
408,11/16/2018,Liechtenstein,Macedonia,0,2,European Nations League D,Liechtenstein,1,-2
409,11/17/2018,Philippines,East Timor,3,2,Southeast Asian Champ,Malaysia,0,1
410,11/17/2018,Australia,South Korea,1,1,Friendly,Australia,1,0
411,11/17/2018,Thailand,Indonesia,4,2,Southeast Asian Champ,Thailand,1,2
412,11/17/2018,Jordan,India,2,1,Friendly,Jordan,1,1
413,11/17/2018,South Africa,Nigeria,1,1,African Nations Cup qualifier,South Africa,1,0
414,11/17/2018,Uganda,Cape Verde,1,0,African Nations Cup qualifier,Uganda,1,1
415,11/17/2018,Gambia,Benin,3,1,African Nations Cup qualifier,The Gambia,0,2
416,11/17/2018,Namibia,Guinea-Bissau,0,0,African Nations Cup qualifier,Namibia,1,0
417,11/17/2018,Seychelles,Libya,1,8,African Nations Cup qualifier,Seychelles,1,-7
418,11/17/2018,Comoros,Malawi,2,1,African Nations Cup qualifier,Comoros,1,1
419,11/17/2018,Gabon,Mali,0,1,African Nations Cup qualifier,Gabon,1,-1
420,11/17/2018,Equatorial Guinea,Senegal,0,1,African Nations Cup qualifier,Equatorial Guinea,1,-1
421,11/17/2018,Nicaragua,Haiti,0,2,CONCACAF Nations League q,Nicaragua,1,-2
422,11/17/2018,Jamaica,Suriname,2,1,CONCACAF Nations League q,Jamaica,1,1
423,11/17/2018,Cuba,Dominican Republic,1,0,CONCACAF Nations League q,Cuba,1,1
424,11/17/2018,Cayman Islands,Saint Lucia,0,0,CONCACAF Nations League q,Cayman Islands,1,0
425,11/17/2018,Vanuatu,New Caledonia,2,2,Friendly,Vanuatu,1,0
426,11/17/2018,Albania,Scotland,0,4,European Nations League C,Albania,1,-4
427,11/17/2018,Turkey,Sweden,0,1,European Nations League B,Turkey,1,-1
428,11/17/2018,Italy,Portugal,0,0,European Nations League A,Italy,1,0
429,11/17/2018,Romania,Lithuania,3,0,European Nations League C,Romania,1,3
430,11/17/2018,Serbia,Montenegro,2,1,European Nations League C,Serbia,1,1
431,11/17/2018,Malta,Kosovo,0,5,European Nations League D,Malta,1,-5
432,11/17/2018,Azerbaijan,Faroe Islands,2,0,European Nations League D,Azerbaijan,1,2
433,11/18/2018,Lesotho,Tanzania,1,0,African Nations Cup qualifier,Lesotho,1,1
434,11/18/2018,Liberia,Zimbabwe,1,0,African Nations Cup qualifier,Liberia,1,1
435,11/18/2018,Mozambique,Zambia,1,0,African Nations Cup qualifier,Mozambique,1,1
436,11/18/2018,Madagascar,Sudan,1,3,African Nations Cup qualifier,Madagascar,1,-2
437,11/18/2018,Ethiopia,Ghana,0,2,African Nations Cup qualifier,Ethiopia,1,-2
438,11/18/2018,Congo,DR Congo,1,1,African Nations Cup qualifier,Congo,1,0
439,11/18/2018,Togo,Algeria,1,4,African Nations Cup qualifier,Togo,1,-3
440,11/18/2018,Rwanda,Central African Republic,2,2,African Nations Cup qualifier,Rwanda,1,0
441,11/18/2018,Angola,Burkina Faso,2,1,African Nations Cup qualifier,Angola,1,1
442,11/18/2018,Guinea,Ivory Coast,1,1,African Nations Cup qualifier,Guinea,1,0
443,11/18/2018,Eswatini,Niger,1,2,African Nations Cup qualifier,Eswatini,1,-1
444,11/18/2018,Mauritania,Botswana,2,1,African Nations Cup qualifier,Mauritania,1,1
445,11/18/2018,Saint Kitts and Nevis,Canada,0,1,CONCACAF Nations League q,Saint Kitts and Nevis,1,-1
446,11/18/2018,Barbados,US Virgin Islands,3,0,CONCACAF Nations League q,Barbados,1,3
447,11/18/2018,Turks and Caicos Islands,St Vincent & Grenadines,3,2,CONCACAF Nations League q,Turks and Caicos Islands,1,1
448,11/18/2018,Bahamas,Anguilla,1,1,CONCACAF Nations League q,Bahamas,1,0
449,11/18/2018,England,Croatia,2,1,European Nations League A,England,1,1
450,11/18/2018,Northern Ireland,Austria,1,2,European Nations League B,Northern Ireland,1,-1
451,11/18/2018,Hungary,Finland,2,0,European Nations League C,Hungary,1,2
452,11/18/2018,Switzerland,Belgium,5,2,European Nations League A,Switzerland,1,3
453,11/18/2018,Moldova,Luxembourg,1,1,European Nations League D,Moldova,1,0
454,11/18/2018,Greece,Estonia,0,1,European Nations League C,Greece,1,-1
455,11/18/2018,Spain,Bosnia and Herzegovina,1,0,Friendly,Spain,1,1
456,11/18/2018,San Marino,Belarus,0,2,European Nations League D,San Marino,1,-2
457,11/19/2018,Oman,Bahrain,2,1,Friendly,Oman,1,1
458,11/19/2018,Iceland,Qatar,2,2,Friendly,Belgium,0,0
459,11/19/2018,Curaçao,Guadeloupe,6,0,CONCACAF Nations League q,Curaçao,1,6
460,11/19/2018,Martinique,Antigua and Barbuda,4,2,CONCACAF Nations League q,Martinique,1,2
461,11/19/2018,Germany,Netherlands,2,2,European Nations League A,Germany,1,0
462,11/19/2018,Cyprus,Norway,0,2,European Nations League C,Cyprus,1,-2
463,11/19/2018,Denmark,Ireland,0,0,European Nations League B,Denmark,1,0
464,11/19/2018,Andorra,Latvia,0,0,European Nations League D,Andorra,1,0
465,11/19/2018,Bulgaria,Slovenia,1,1,European Nations League C,Bulgaria,1,0
466,11/19/2018,Czechia,Slovakia,1,0,European Nations League B,Czechia,1,1
467,11/19/2018,Liechtenstein,Armenia,2,2,European Nations League D,Liechtenstein,1,0
468,11/19/2018,Georgia,Kazakhstan,2,1,European Nations League D,Georgia,1,1
469,11/19/2018,Macedonia,Gibraltar,4,0,European Nations League D,Macedonia,1,4
470,11/20/2018,Japan,Kyrgyzstan,4,0,Friendly,Japan,1,4
471,11/20/2018,Australia,Lebanon,3,0,Friendly,Australia,1,3
472,11/20/2018,China,Palestine,1,1,Friendly,China,1,0
473,11/20/2018,Iran,Venezuela,1,1,Friendly,Qatar,0,0
474,11/20/2018,South Korea,Uzbekistan,4,0,Friendly,Australia,0,4
475,11/20/2018,Myanmar,Vietnam,0,0,Southeast Asian Champ,Myanmar,1,0
476,11/20/2018,Kuwait,Syria,1,2,Friendly,Kuwait,1,-1
477,11/20/2018,Cambodia,Laos,3,1,Southeast Asian Champ,Cambodia,1,2
478,11/20/2018,Bolivia,Iraq,0,0,Friendly,United Arab Emirates,0,0
479,11/20/2018,Jordan,Saudi Arabia,1,1,Friendly,Jordan,1,0
480,11/20/2018,United Arab Emirates,Yemen,2,0,Friendly,United Arab Emirates,1,2
481,11/20/2018,South Africa,Paraguay,1,1,Friendly tournament,South Africa,1,0
482,11/20/2018,Nigeria,Uganda,0,0,Friendly,Nigeria,1,0
483,11/20/2018,Tunisia,Morocco,0,1,Friendly,Tunisia,1,-1
484,11/20/2018,Brazil,Cameroon,1,0,Friendly,England,0,1
485,11/20/2018,Italy,United States,1,0,Friendly,Belgium,0,1
486,11/20/2018,Peru,Costa Rica,2,3,Friendly,Peru,1,-1
487,11/20/2018,El Salvador,Haiti,1,0,Friendly,El Salvador,1,1
488,11/20/2018,Argentina,Mexico,2,0,Friendly,Argentina,1,2
489,11/20/2018,Chile,Honduras,4,1,Friendly,Chile,1,3
490,11/20/2018,French Guiana,Guyana,2,1,CONCACAF Nations League q,French Guiana,1,1
491,11/20/2018,Dominica,Sint Maarten,2,0,CONCACAF Nations League q,Anguilla,0,2
492,11/20/2018,Panama,Ecuador,1,2,Friendly,Panama,1,-1
493,11/20/2018,France,Uruguay,1,0,Friendly,France,1,1
494,11/20/2018,Scotland,Israel,3,2,European Nations League C,Scotland,1,1
495,11/20/2018,Albania,Wales,1,0,Friendly,Albania,1,1
496,11/20/2018,Sweden,Russia,2,0,European Nations League B,Sweden,1,2
497,11/20/2018,Portugal,Poland,1,1,European Nations League A,Portugal,1,0
498,11/20/2018,Montenegro,Romania,0,1,European Nations League C,Montenegro,1,-1
499,11/20/2018,Serbia,Lithuania,4,1,European Nations League C,Serbia,1,3
500,11/20/2018,Turkey,Ukraine,0,0,Friendly,Turkey,1,0
501,11/20/2018,Malta,Faroe Islands,1,1,European Nations League D,Malta,1,0
502,11/20/2018,Kosovo,Azerbaijan,4,0,European Nations League D,Kosovo,1,4
503,11/21/2018,Philippines,Thailand,1,1,Southeast Asian Champ,Philippines,1,0
504,11/21/2018,Singapore,East Timor,6,1,Southeast Asian Champ,Singapore,1,5
505,11/24/2018,Vietnam,Cambodia,3,0,Southeast Asian Champ,Vietnam,1,3
506,11/24/2018,Malaysia,Myanmar,3,0,Southeast Asian Champ,Malaysia,1,3
507,11/25/2018,Indonesia,Philippines,0,0,Southeast Asian Champ,Indonesia,1,0
508,11/25/2018,Thailand,Singapore,3,0,Southeast Asian Champ,Thailand,1,3
509,12/1/2018,Malaysia,Thailand,0,0,Southeast Asian Champ,Malaysia,1,0
510,12/2/2018,Philippines,Vietnam,1,2,Southeast Asian Champ,Philippines,1,-1
511,12/5/2018,Thailand,Malaysia,2,2,Southeast Asian Champ,Thailand,1,0
512,12/6/2018,Vietnam,Philippines,2,1,Southeast Asian Champ,Vietnam,1,1
513,12/11/2018,Malaysia,Vietnam,2,2,Southeast Asian Champ,Malaysia,1,0
514,12/13/2018,Oman,Tajikistan,2,1,Friendly,Oman,1,1
515,12/15/2018,Vietnam,Malaysia,1,0,Southeast Asian Champ,Vietnam,1,1
516,12/16/2018,Palestine,Pakistan,2,0,Friendly,Qatar,0,2
517,12/16/2018,Oman,Tajikistan,1,0,Friendly,Oman,1,1
518,12/20/2018,Kyrgyzstan,Jordan,1,0,Friendly,Qatar,0,1
519,12/20/2018,Bahrain,Tajikistan,5,0,Friendly,Bahrain,1,5
520,12/23/2018,Qatar,Jordan,2,0,Friendly,Qatar,1,2
521,12/24/2018,Iraq,China,2,1,Friendly,Qatar,0,1
522,12/24/2018,Iran,Palestine,1,1,Friendly,Qatar,0,0
523,12/25/2018,Turkmenistan,Afghanistan,2,0,Friendly,Turkey,0,2
524,12/25/2018,Vietnam,North Korea,1,1,Friendly,Vietnam,1,0
525,12/25/2018,Qatar,Kyrgyzstan,1,0,Friendly,Qatar,1,1
526,12/27/2018,India,Oman,0,0,Friendly,United Arab Emirates,0,0
527,12/27/2018,Bahrain,Lebanon,1,0,Friendly,Bahrain,1,1
528,12/27/2018,Qatar,Algeria,0,1,Friendly,Qatar,1,-1
529,12/28/2018,China,Jordan,1,1,Friendly,Qatar,0,0
530,12/28/2018,Afghanistan,Turkmenistan,2,2,Friendly,Turkey,0,0
531,12/28/2018,Iraq,Palestine,1,0,Friendly,Qatar,0,1
532,12/28/2018,United Arab Emirates,Kuwait,0,2,Friendly,United Arab Emirates,1,-2
533,12/29/2018,Bahrain,North Korea,4,0,Friendly,Bahrain,1,4
534,12/30/2018,Australia,Oman,5,0,Friendly,United Arab Emirates,0,5
535,12/30/2018,Syria,Yemen,1,0,Friendly,United Arab Emirates,0,1
536,12/31/2018,Vietnam,Philippines,4,2,Friendly,Qatar,0,2
537,12/31/2018,Qatar,Iran,1,2,Friendly,Qatar,1,-1
538,12/31/2018,Saudi Arabia,South Korea,0,0,Friendly,United Arab Emirates,0,0
539,12/31/2018,Kyrgyzstan,Palestine,2,1,Friendly,Qatar,0,1
540,1/2/2019,Oman,Thailand,2,0,Friendly,United Arab Emirates,0,2
541,1/5/2019,United Arab Emirates,Bahrain,1,1,Asian Cup,United Arab Emirates,1,0
542,1/6/2019,Jordan,Australia,1,0,Asian Cup,United Arab Emirates,0,1
543,1/6/2019,India,Thailand,4,1,Asian Cup,United Arab Emirates,0,3
544,1/6/2019,Palestine,Syria,0,0,Asian Cup,United Arab Emirates,0,0
545,1/7/2019,South Korea,Philippines,1,0,Asian Cup,United Arab Emirates,0,1
546,1/7/2019,China,Kyrgyzstan,2,1,Asian Cup,United Arab Emirates,0,1
547,1/7/2019,Iran,Yemen,5,0,Asian Cup,United Arab Emirates,0,5
548,1/8/2019,Iraq,Vietnam,3,2,Asian Cup,United Arab Emirates,0,1
549,1/8/2019,Saudi Arabia,North Korea,4,0,Asian Cup,United Arab Emirates,0,4
550,1/8/2019,Finland,Sweden,1,0,Friendly,Qatar,0,1
551,1/9/2019,Japan,Turkmenistan,3,2,Asian Cup,United Arab Emirates,0,1
552,1/9/2019,Qatar,Lebanon,2,0,Asian Cup,United Arab Emirates,0,2
553,1/9/2019,Uzbekistan,Oman,2,1,Asian Cup,United Arab Emirates,0,1
554,1/10/2019,United Arab Emirates,India,2,0,Asian Cup,United Arab Emirates,1,2
555,1/10/2019,Jordan,Syria,2,0,Asian Cup,United Arab Emirates,0,2
556,1/10/2019,Thailand,Bahrain,1,0,Asian Cup,United Arab Emirates,0,1
557,1/11/2019,China,Philippines,3,0,Asian Cup,United Arab Emirates,0,3
558,1/11/2019,Australia,Palestine,3,0,Asian Cup,United Arab Emirates,0,3
559,1/11/2019,South Korea,Kyrgyzstan,1,0,Asian Cup,United Arab Emirates,0,1
560,1/11/2019,Iceland,Sweden,2,2,Friendly,Qatar,0,0
561,1/11/2019,Estonia,Finland,2,1,Friendly,Qatar,0,1
562,1/12/2019,Saudi Arabia,Lebanon,2,0,Asian Cup,United Arab Emirates,0,2
563,1/12/2019,Iran,Vietnam,2,0,Asian Cup,United Arab Emirates,0,2
564,1/12/2019,Iraq,Yemen,3,0,Asian Cup,United Arab Emirates,0,3
565,1/13/2019,Japan,Oman,1,0,Asian Cup,United Arab Emirates,0,1
566,1/13/2019,Qatar,North Korea,6,0,Asian Cup,United Arab Emirates,0,6
567,1/13/2019,Uzbekistan,Turkmenistan,4,0,Asian Cup,United Arab Emirates,0,4
568,1/14/2019,Bahrain,India,1,0,Asian Cup,United Arab Emirates,0,1
569,1/14/2019,United Arab Emirates,Thailand,1,1,Asian Cup,United Arab Emirates,1,0
570,1/15/2019,Australia,Syria,3,2,Asian Cup,United Arab Emirates,0,1
571,1/15/2019,Jordan,Palestine,0,0,Asian Cup,United Arab Emirates,0,0
572,1/15/2019,Estonia,Iceland,0,0,Friendly,Qatar,0,0
573,1/16/2019,Kyrgyzstan,Philippines,3,1,Asian Cup,United Arab Emirates,0,2
574,1/16/2019,South Korea,China,2,0,Asian Cup,United Arab Emirates,0,2
575,1/16/2019,Iran,Iraq,0,0,Asian Cup,United Arab Emirates,0,0
576,1/16/2019,Vietnam,Yemen,2,0,Asian Cup,United Arab Emirates,0,2
577,1/17/2019,Japan,Uzbekistan,2,1,Asian Cup,United Arab Emirates,0,1
578,1/17/2019,Lebanon,North Korea,4,1,Asian Cup,United Arab Emirates,0,3
579,1/17/2019,Qatar,Saudi Arabia,2,0,Asian Cup,United Arab Emirates,0,2
580,1/17/2019,Oman,Turkmenistan,3,1,Asian Cup,United Arab Emirates,0,2
581,1/20/2019,China,Thailand,2,1,Asian Cup,United Arab Emirates,0,1
582,1/20/2019,Iran,Oman,2,0,Asian Cup,United Arab Emirates,0,2
583,1/20/2019,Jordan,Vietnam,1,1,Asian Cup,United Arab Emirates,0,0
584,1/21/2019,Japan,Saudi Arabia,1,0,Asian Cup,United Arab Emirates,0,1
585,1/21/2019,Australia,Uzbekistan,0,0,Asian Cup,United Arab Emirates,0,0
586,1/21/2019,United Arab Emirates,Kyrgyzstan,3,2,Asian Cup,United Arab Emirates,1,1
587,1/22/2019,South Korea,Bahrain,2,1,Asian Cup,United Arab Emirates,0,1
588,1/22/2019,Qatar,Iraq,1,0,Asian Cup,United Arab Emirates,0,1
589,1/24/2019,Japan,Vietnam,1,0,Asian Cup,United Arab Emirates,0,1
590,1/24/2019,Iran,China,3,0,Asian Cup,United Arab Emirates,0,3
591,1/25/2019,United Arab Emirates,Australia,1,0,Asian Cup,United Arab Emirates,1,1
592,1/25/2019,Qatar,South Korea,1,0,Asian Cup,United Arab Emirates,0,1
593,1/27/2019,United States,Panama,3,0,Friendly,United States,1,3
594,1/28/2019,Japan,Iran,3,0,Asian Cup,United Arab Emirates,0,3
595,1/29/2019,United Arab Emirates,Qatar,0,4,Asian Cup,United Arab Emirates,1,-4
596,2/1/2019,Qatar,Japan,3,1,Asian Cup,United Arab Emirates,0,2
597,2/2/2019,United States,Costa Rica,2,0,Friendly,United States,1,2
598,2/16/2019,Dominican Republic,Guadeloupe,1,0,Friendly,Dominican Republic,1,1
599,2/21/2019,Kazakhstan,Moldova,1,0,Friendly,Turkey,0,1
600,2/23/2019,Sint Maarten,Saint Barthelemy,1,1,Friendly,Sint Maarten,1,0
601,2/25/2019,Cuba,Bermuda,2,2,Friendly,Cuba,1,0
602,2/27/2019,Cuba,Bermuda,5,0,Friendly,Cuba,1,5
603,2/28/2019,St Vincent & Grenadines,Barbados,2,0,Windward Islands Champ,St Vincent & Grenadines,1,2
604,2/28/2019,Grenada,Saint Lucia,1,0,Windward Islands Champ,St Vincent & Grenadines,0,1
605,3/2/2019,Dominica,Grenada,1,0,Windward Islands Champ,St Vincent & Grenadines,0,1
606,3/2/2019,St Vincent & Grenadines,Saint Lucia,2,1,Windward Islands Champ,St Vincent & Grenadines,1,1
607,3/3/2019,Bolivia,Nicaragua,2,2,Friendly,Bolivia,1,0
608,3/4/2019,Barbados,Grenada,0,0,Windward Islands Champ,St Vincent & Grenadines,0,0
609,3/4/2019,Dominica,Saint Lucia,1,1,Windward Islands Champ,St Vincent & Grenadines,0,0
610,3/6/2019,El Salvador,Guatemala,3,1,Friendly,United States,0,2
611,3/6/2019,Barbados,Saint Lucia,2,0,Windward Islands Champ,St Vincent & Grenadines,0,2
612,3/6/2019,St Vincent & Grenadines,Dominica,2,1,Windward Islands Champ,St Vincent & Grenadines,1,1
613,3/8/2019,Barbados,Dominica,2,0,Windward Islands Champ,St Vincent & Grenadines,0,2
614,3/8/2019,St Vincent & Grenadines,Grenada,1,1,Windward Islands Champ,St Vincent & Grenadines,1,0
615,3/9/2019,Cambodia,Bangladesh,0,1,Friendly,Cambodia,1,-1
616,3/10/2019,Mozambique,Eswatini,1,1,Friendly,South Africa,0,0
617,3/10/2019,Anguilla,Saint Martin,2,1,Friendly,Anguilla,1,1
618,3/16/2019,Suriname,Guyana,3,1,Friendly,Suriname,1,2
619,3/16/2019,Bahamas,Turks and Caicos Islands,6,1,Friendly,Bahamas,1,5
620,3/17/2019,Saint Barthelemy,Saint Martin,4,3,Friendly,Saint Barthelemy,1,1
621,3/18/2019,Fiji,New Caledonia,3,0,Friendly tournament,Fiji,1,3
622,3/18/2019,Solomon Islands,Vanuatu,3,1,Friendly,Solomon Islands,1,2
623,3/19/2019,Myanmar,Taiwan,0,0,Friendly,Myanmar,1,0
624,3/20/2019,Oman,Afghanistan,5,0,Friendly tournament,Malaysia,0,5
625,3/20/2019,Iraq,Syria,1,0,Friendly tournament,Iraq,1,1
626,3/20/2019,Malaysia,Singapore,0,1,Friendly tournament,Malaysia,1,-1
627,3/20/2019,Wales,Trinidad and Tobago,1,0,Friendly,Wales,1,1
628,3/20/2019,Germany,Serbia,1,1,Friendly,Germany,1,0
629,3/21/2019,China,Thailand,0,1,Friendly tournament,China,1,-1
630,3/21/2019,Kuwait,Nepal,0,0,Friendly,Kuwait,1,0
631,3/21/2019,United Arab Emirates,Saudi Arabia,2,1,Friendly,United Arab Emirates,1,1
632,3/21/2019,Mauritius,New Caledonia,3,1,Friendly tournament,Fiji,0,2
633,3/21/2019,United States,Ecuador,1,0,Friendly,United States,1,1
634,3/21/2019,St Vincent & Grenadines,Bonaire,2,1,CONCACAF Nations League q,St Vincent & Grenadines,1,1
635,3/21/2019,British Virgin Islands,Turks and Caicos Islands,2,2,CONCACAF Nations League q,Anguilla,0,0
636,3/21/2019,Kazakhstan,Scotland,3,0,European Championship qual,Kazakhstan,1,3
637,3/21/2019,Northern Ireland,Estonia,2,0,European Championship qual,Northern Ireland,1,2
638,3/21/2019,Austria,Poland,0,1,European Championship qual,Austria,1,-1
639,3/21/2019,Slovakia,Hungary,2,0,European Championship qual,Slovakia,1,2
640,3/21/2019,Belgium,Russia,3,1,European Championship qual,Belgium,1,2
641,3/21/2019,Netherlands,Belarus,4,0,European Championship qual,Netherlands,1,4
642,3/21/2019,Kosovo,Denmark,2,2,Friendly,Kosovo,1,0
643,3/21/2019,North Macedonia,Latvia,3,1,European Championship qual,North Macedonia,1,2
644,3/21/2019,Israel,Slovenia,1,1,European Championship qual,Israel,1,0
645,3/21/2019,Croatia,Azerbaijan,2,1,European Championship qual,Croatia,1,1
646,3/21/2019,Cyprus,San Marino,5,0,European Championship qual,Cyprus,1,5
647,3/22/2019,Japan,Colombia,0,1,Friendly,Japan,1,-1
648,3/22/2019,South Korea,Bolivia,1,0,Friendly,South Korea,1,1
649,3/22/2019,Uruguay,Uzbekistan,3,0,Friendly tournament,China,0,3
650,3/22/2019,Nigeria,Seychelles,3,1,African Nations Cup qualifier,Nigeria,1,2
651,3/22/2019,Algeria,Gambia,1,1,African Nations Cup qualifier,Algeria,1,0
652,3/22/2019,Sudan,Equatorial Guinea,1,4,African Nations Cup qualifier,Sudan,1,-3
653,3/22/2019,Tunisia,Eswatini,4,0,African Nations Cup qualifier,Tunisia,1,4
654,3/22/2019,Malawi,Morocco,0,0,African Nations Cup qualifier,Malawi,1,0
655,3/22/2019,Burkina Faso,Mauritania,1,0,African Nations Cup qualifier,Burkina Faso,1,1
656,3/22/2019,Botswana,Angola,0,1,African Nations Cup qualifier,Botswana,1,-1
657,3/22/2019,Guatemala,Costa Rica,1,0,Friendly,Guatemala,1,1
658,3/22/2019,Mexico,Chile,3,1,Friendly,United States,0,2
659,3/22/2019,Saint Lucia,Aruba,3,2,CONCACAF Nations League q,Antigua and Barbuda,0,1
660,3/22/2019,Cayman Islands,Montserrat,1,2,CONCACAF Nations League q,Cayman Islands,1,-1
661,3/22/2019,Anguilla,US Virgin Islands,0,3,CONCACAF Nations League q,Anguilla,1,-3
662,3/22/2019,Venezuela,Argentina,3,1,Friendly,Spain,0,2
663,3/22/2019,Peru,Paraguay,1,0,Friendly,United States,0,1
664,3/22/2019,England,Czechia,5,0,European Championship qual,England,1,5
665,3/22/2019,Moldova,France,1,4,European Championship qual,Moldova,1,-3
666,3/22/2019,Luxembourg,Lithuania,2,1,European Championship qual,Luxembourg,1,1
667,3/22/2019,Portugal,Ukraine,0,0,European Championship qual,Portugal,1,0
668,3/22/2019,Albania,Turkey,0,2,European Championship qual,Albania,1,-2
669,3/22/2019,Bulgaria,Montenegro,1,1,European Championship qual,Bulgaria,1,0
670,3/22/2019,Andorra,Iceland,0,2,European Championship qual,Andorra,1,-2
671,3/23/2019,Malaysia,Afghanistan,2,1,Friendly tournament,Malaysia,1,1
672,3/23/2019,Syria,Jordan,1,0,Friendly tournament,Iraq,0,1
673,3/23/2019,Oman,Singapore,1,1,Friendly tournament,Malaysia,0,0
674,3/23/2019,Niger,Egypt,1,1,African Nations Cup qualifier,Niger,1,0
675,3/23/2019,Ghana,Kenya,1,0,African Nations Cup qualifier,Ghana,1,1
676,3/23/2019,Zambia,Namibia,4,1,African Nations Cup qualifier,Zambia,1,3
677,3/23/2019,Senegal,Madagascar,2,0,African Nations Cup qualifier,Senegal,1,2
678,3/23/2019,Guinea-Bissau,Mozambique,2,2,African Nations Cup qualifier,Guinea-Bissau,1,0
679,3/23/2019,Burundi,Gabon,1,1,African Nations Cup qualifier,Burundi,1,0
680,3/23/2019,Cameroon,Comoros,3,0,African Nations Cup qualifier,Cameroon,1,3
681,3/23/2019,Mali,South Sudan,3,0,African Nations Cup qualifier,Mali,1,3
682,3/23/2019,Ivory Coast,Rwanda,3,0,African Nations Cup qualifier,Ivory Coast,1,3
683,3/23/2019,El Salvador,Jamaica,2,0,CONCACAF Nations League q,El Salvador,1,2
684,3/23/2019,Antigua and Barbuda,Curaçao,2,1,CONCACAF Nations League q,Antigua and Barbuda,1,1
685,3/23/2019,Guyana,Belize,2,1,CONCACAF Nations League q,Guyana,1,1
686,3/23/2019,Guadeloupe,Martinique,0,1,CONCACAF Nations League q,Guadeloupe,1,-1
687,3/23/2019,Dominica,Bahamas,4,0,CONCACAF Nations League q,Dominica,1,4
688,3/23/2019,Suriname,Saint Kitts and Nevis,2,0,CONCACAF Nations League q,Suriname,1,2
689,3/23/2019,Brazil,Panama,1,1,Friendly,Portugal,0,0
690,3/23/2019,Sint Maarten,Saint Martin,4,3,CONCACAF Nations League q,Anguilla,0,1
691,3/23/2019,Georgia,Switzerland,0,2,European Championship qual,Georgia,1,-2
692,3/23/2019,Sweden,Romania,2,1,European Championship qual,Sweden,1,1
693,3/23/2019,Spain,Norway,2,1,European Championship qual,Spain,1,1
694,3/23/2019,Italy,Finland,2,0,European Championship qual,Italy,1,2
695,3/23/2019,Gibraltar,Ireland,0,1,European Championship qual,Gibraltar,1,-1
696,3/23/2019,Liechtenstein,Greece,0,2,European Championship qual,Liechtenstein,1,-2
697,3/23/2019,Malta,Faroe Islands,2,1,European Championship qual,Malta,1,1
698,3/23/2019,Bosnia and Herzegovina,Armenia,2,1,European Championship qual,Bosnia and Herzegovina,1,1
699,3/24/2019,Taiwan,Solomon Islands,0,1,Friendly,Taiwan,1,-1
700,3/24/2019,South Africa,Libya,2,1,African Nations Cup qualifier,Tunisia,0,1
701,3/24/2019,Tanzania,Uganda,3,0,African Nations Cup qualifier,Tanzania,1,3
702,3/24/2019,Zimbabwe,Congo,2,0,African Nations Cup qualifier,Zimbabwe,1,2
703,3/24/2019,Fiji,Mauritius,1,0,Friendly tournament,Fiji,1,1
704,3/24/2019,DR Congo,Liberia,1,0,African Nations Cup qualifier,DR Congo,1,1
705,3/24/2019,Benin,Togo,2,1,African Nations Cup qualifier,Benin,1,1
706,3/24/2019,Cape Verde,Lesotho,0,0,African Nations Cup qualifier,Cape Verde,1,0
707,3/24/2019,Central African Republic,Guinea,0,0,African Nations Cup qualifier,Central African Republic,1,0
708,3/24/2019,Canada,French Guiana,4,1,CONCACAF Nations League q,Canada,1,3
709,3/24/2019,Haiti,Cuba,2,1,CONCACAF Nations League q,Haiti,1,1
710,3/24/2019,Barbados,Nicaragua,0,1,CONCACAF Nations League q,Barbados,1,-1
711,3/24/2019,Puerto Rico,Grenada,0,2,CONCACAF Nations League q,Puerto Rico,1,-2
712,3/24/2019,Dominican Republic,Bermuda,1,3,CONCACAF Nations League q,Dominican Republic,1,-2
713,3/24/2019,Bonaire,British Virgin Islands,2,1,CONCACAF Nations League q,Anguilla,0,1
714,3/24/2019,San Marino,Scotland,0,2,European Championship qual,San Marino,1,-2
715,3/24/2019,Wales,Slovakia,1,0,European Championship qual,Wales,1,1
716,3/24/2019,Northern Ireland,Belarus,2,1,European Championship qual,Northern Ireland,1,1
717,3/24/2019,Israel,Austria,4,2,European Championship qual,Israel,1,2
718,3/24/2019,Hungary,Croatia,2,1,European Championship qual,Hungary,1,1
719,3/24/2019,Cyprus,Belgium,0,2,European Championship qual,Cyprus,1,-2
720,3/24/2019,Netherlands,Germany,2,3,European Championship qual,Netherlands,1,-1
721,3/24/2019,Kazakhstan,Russia,0,4,European Championship qual,Kazakhstan,1,-4
722,3/24/2019,Poland,Latvia,2,0,European Championship qual,Poland,1,2
723,3/24/2019,Slovenia,North Macedonia,1,1,European Championship qual,Slovenia,1,0
724,3/25/2019,China,Uzbekistan,0,1,Friendly tournament,China,1,-1
725,3/25/2019,Myanmar,Indonesia,0,2,Friendly,Myanmar,1,-2
726,3/25/2019,Uruguay,Thailand,4,0,Friendly tournament,China,0,4
727,3/25/2019,Kuwait,Nepal,1,0,Friendly,Kuwait,1,1
728,3/25/2019,Saudi Arabia,Equatorial Guinea,3,2,Friendly,Saudi Arabia,1,1
729,3/25/2019,Montenegro,England,1,5,European Championship qual,Montenegro,1,-4
730,3/25/2019,France,Iceland,4,0,European Championship qual,France,1,4
731,3/25/2019,Luxembourg,Ukraine,1,2,European Championship qual,Luxembourg,1,-1
732,3/25/2019,Portugal,Serbia,1,1,European Championship qual,Portugal,1,0
733,3/25/2019,Azerbaijan,Lithuania,0,0,Friendly,Azerbaijan,1,0
734,3/25/2019,Turkey,Moldova,4,0,European Championship qual,Turkey,1,4
735,3/25/2019,Kosovo,Bulgaria,1,1,European Championship qual,Kosovo,1,0
736,3/25/2019,Andorra,Albania,0,3,European Championship qual,Andorra,1,-3
737,3/26/2019,Japan,Bolivia,1,0,Friendly,Japan,1,1
738,3/26/2019,South Korea,Colombia,2,1,Friendly,South Korea,1,1
739,3/26/2019,United Arab Emirates,Syria,0,0,Friendly,United Arab Emirates,1,0
740,3/26/2019,Iraq,Jordan,3,2,Friendly tournament,Iraq,1,1
741,3/26/2019,Nigeria,Egypt,1,0,Friendly,Nigeria,1,1
742,3/26/2019,Ghana,Mauritania,3,1,Friendly,Ghana,1,2
743,3/26/2019,Algeria,Tunisia,1,0,Friendly,Algeria,1,1
744,3/26/2019,Morocco,Argentina,0,1,Friendly,Morocco,1,-1
745,3/26/2019,Senegal,Mali,2,1,Friendly,Senegal,1,1
746,3/26/2019,Ivory Coast,Liberia,1,0,Friendly,Ivory Coast,1,1
747,3/26/2019,United States,Chile,1,1,Friendly,United States,1,0
748,3/26/2019,Costa Rica,Jamaica,1,0,Friendly,Costa Rica,1,1
749,3/26/2019,El Salvador,Peru,2,0,Friendly,United States,0,2
750,3/26/2019,Nicaragua,Guatemala,0,1,Friendly,Nicaragua,1,-1
751,3/26/2019,Mexico,Paraguay,4,2,Friendly,United States,0,2
752,3/26/2019,Ecuador,Honduras,0,0,Friendly,United States,0,0
753,3/26/2019,Czechia,Brazil,1,3,Friendly,Czechia,1,-2
754,3/26/2019,Switzerland,Denmark,3,3,European Championship qual,Switzerland,1,0
755,3/26/2019,Norway,Sweden,3,3,European Championship qual,Norway,1,0
756,3/26/2019,Italy,Liechtenstein,6,0,European Championship qual,Italy,1,6
757,3/26/2019,Armenia,Finland,0,2,European Championship qual,Armenia,1,-2
758,3/26/2019,Gibraltar,Estonia,0,1,Friendly,Gibraltar,1,-1
759,3/26/2019,Malta,Spain,0,2,European Championship qual,Malta,1,-2
760,3/26/2019,Romania,Faroe Islands,4,1,European Championship qual,Romania,1,3
761,3/26/2019,Ireland,Georgia,1,0,European Championship qual,Ireland,1,1
762,3/26/2019,Bosnia and Herzegovina,Greece,2,2,European Championship qual,Bosnia and Herzegovina,1,0
763,5/25/2019,Mauritius,Eswatini,2,2,COSAFA Cup,South Africa,0,0
764,5/26/2019,Malawi,Seychelles,3,0,COSAFA Cup,South Africa,0,3
765,5/26/2019,Namibia,Mozambique,2,1,COSAFA Cup,South Africa,0,1
766,5/27/2019,Comoros,Eswatini,2,2,COSAFA Cup,South Africa,0,0
767,5/28/2019,Laos,Sri Lanka,2,1,Friendly,Laos,1,1
768,5/28/2019,Malawi,Namibia,2,1,COSAFA Cup,South Africa,0,1
769,5/28/2019,Mozambique,Seychelles,0,0,COSAFA Cup,South Africa,0,0
770,5/29/2019,Comoros,Mauritius,2,1,COSAFA Cup,South Africa,0,1
771,5/29/2019,Cayman Islands,Cuba,0,0,Friendly,Cayman Islands,1,0
772,5/30/2019,Malawi,Mozambique,1,1,COSAFA Cup,South Africa,0,0
773,5/30/2019,Namibia,Seychelles,3,0,COSAFA Cup,South Africa,0,3
774,5/30/2019,Turkey,Greece,2,1,Friendly,Turkey,1,1
775,5/31/2019,Laos,Sri Lanka,2,2,Friendly,Laos,1,0
776,5/31/2019,Cayman Islands,Cuba,0,1,Friendly,Cayman Islands,1,-1
777,6/1/2019,Lesotho,Uganda,0,0,COSAFA Cup,South Africa,0,0
778,6/1/2019,Zimbabwe,Comoros,2,0,COSAFA Cup,South Africa,0,2
779,6/1/2019,Ecuador,Venezuela,1,1,Friendly,United States,0,0
780,6/2/2019,Malaysia,Nepal,2,0,Friendly,Malaysia,1,2
781,6/2/2019,Turkey,Uzbekistan,2,0,Friendly,Turkey,1,2
782,6/2/2019,South Africa,Botswana,2,2,COSAFA Cup,South Africa,1,0
783,6/2/2019,Malawi,Zambia,2,2,COSAFA Cup,South Africa,0,0
784,6/2/2019,Luxembourg,Madagascar,3,3,Friendly,Luxembourg,1,0
785,6/2/2019,El Salvador,Haiti,1,0,Friendly,United States,0,1
786,6/2/2019,France,Bolivia,2,0,Friendly,France,1,2
787,6/3/2019,Colombia,Panama,3,0,Friendly,Colombia,1,3
788,6/4/2019,South Africa,Uganda,1,1,COSAFA Cup,South Africa,1,0
789,6/4/2019,Malawi,Comoros,2,1,COSAFA Cup,South Africa,0,1
790,6/4/2019,Vanuatu,Tahiti,2,0,Friendly tournament,Vanuatu,1,2
791,6/5/2019,Japan,Trinidad and Tobago,0,0,Friendly,Japan,1,0
792,6/5/2019,Curaçao,India,3,1,King's Cup,Thailand,0,2
793,6/5/2019,Thailand,Vietnam,0,1,King's Cup,Thailand,1,-1
794,6/5/2019,Brazil,Qatar,2,0,Friendly,Brazil,1,2
795,6/5/2019,Zambia,Zimbabwe,0,0,COSAFA Cup,South Africa,0,0
796,6/5/2019,Botswana,Lesotho,2,1,COSAFA Cup,South Africa,0,1
797,6/5/2019,United States,Jamaica,0,1,Friendly,United States,1,-1
798,6/5/2019,Peru,Costa Rica,1,0,Friendly,Peru,1,1
799,6/5/2019,Mexico,Venezuela,3,1,Friendly,United States,0,2
800,6/5/2019,Paraguay,Honduras,1,1,Friendly,Paraguay,1,0
801,6/5/2019,Portugal,Switzerland,3,1,European Nations League,Portugal,1,2
802,6/6/2019,Iran,Syria,5,0,Friendly,Iran,1,5
803,6/6/2019,Mongolia,Brunei,2,0,World Cup and Asian Cup qual,Mongolia,1,2
804,6/6/2019,Macao,Sri Lanka,1,0,World Cup and Asian Cup qual,China,0,1
805,6/6/2019,Taiwan,Nepal,1,1,Friendly,Taiwan,1,0
806,6/6/2019,Cambodia,Pakistan,2,0,World Cup and Asian Cup qual,Cambodia,1,2
807,6/6/2019,Laos,Bangladesh,0,1,World Cup and Asian Cup qual,Laos,1,-1
808,6/6/2019,Bhutan,Guam,1,0,World Cup and Asian Cup qual,Bhutan,1,1
809,6/6/2019,Chile,Haiti,2,1,Friendly,Chile,1,1
810,6/6/2019,Bermuda,Guyana,1,0,Friendly,Bermuda,1,1
811,6/6/2019,Netherlands,England,3,1,European Nations League,Portugal,0,2
812,6/7/2019,China,Philippines,2,0,Friendly,China,1,2
813,6/7/2019,South Korea,Australia,1,0,Friendly,South Korea,1,1
814,6/7/2019,Tajikistan,Afghanistan,1,1,Friendly,Tajikistan,1,0
815,6/7/2019,Malaysia,East Timor,7,1,World Cup qualifier,Malaysia,1,6
816,6/7/2019,Uzbekistan,North Korea,4,0,Friendly,Uzbekistan,1,4
817,6/7/2019,Tunisia,Iraq,2,0,Friendly,Tunisia,1,2
818,6/7/2019,Slovakia,Jordan,5,1,Friendly,Slovakia,1,4
819,6/7/2019,South Africa,Malawi,0,0,COSAFA Cup,South Africa,1,0
820,6/7/2019,Kenya,Madagascar,1,0,Friendly,France,0,1
821,6/7/2019,Lesotho,Zimbabwe,2,2,COSAFA Cup,South Africa,0,0
822,6/7/2019,Gambia,Guinea,1,0,Friendly,Morocco,0,1
823,6/7/2019,Ivory Coast,Comoros,3,1,Friendly,France,0,2
824,6/7/2019,Argentina,Nicaragua,5,1,Friendly,Argentina,1,4
825,6/7/2019,Uruguay,Panama,3,0,Friendly,Uruguay,1,3
826,6/7/2019,Fiji,Tahiti,1,1,Friendly tournament,Vanuatu,0,0
827,6/7/2019,Austria,Slovenia,1,0,European Championship qual,Austria,1,1
828,6/7/2019,Sweden,Malta,3,0,European Championship qual,Sweden,1,3
829,6/7/2019,Norway,Romania,2,2,European Championship qual,Norway,1,0
830,6/7/2019,Lithuania,Luxembourg,1,1,European Championship qual,Lithuania,1,0
831,6/7/2019,Denmark,Ireland,1,1,European Championship qual,Denmark,1,0
832,6/7/2019,North Macedonia,Poland,0,1,European Championship qual,North Macedonia,1,-1
833,6/7/2019,Faroe Islands,Spain,1,4,European Championship qual,Faroe Islands,1,-3
834,6/7/2019,Latvia,Israel,0,3,European Championship qual,Latvia,1,-3
835,6/7/2019,Czechia,Bulgaria,2,1,European Championship qual,Czechia,1,1
836,6/7/2019,Ukraine,Serbia,5,0,European Championship qual,Ukraine,1,5
837,6/7/2019,Montenegro,Kosovo,1,1,European Championship qual,Montenegro,1,0
838,6/7/2019,Georgia,Gibraltar,3,0,European Championship qual,Georgia,1,3
839,6/8/2019,Thailand,India,0,1,King's Cup,Thailand,1,-1
840,6/8/2019,Curaçao,Vietnam,1,1,King's Cup,Thailand,0,0
841,6/8/2019,Singapore,Solomon Islands,4,3,Friendly,Singapore,1,1
842,6/8/2019,Nigeria,Zimbabwe,0,0,Friendly,Nigeria,1,0
843,6/8/2019,Zambia,Botswana,1,0,COSAFA Cup,South Africa,0,1
844,6/8/2019,Angola,Guinea-Bissau,2,0,Friendly,Portugal,0,2
845,6/8/2019,Scotland,Cyprus,2,1,European Championship qual,Scotland,1,1
846,6/8/2019,Croatia,Wales,2,1,European Championship qual,Croatia,1,1
847,6/8/2019,Estonia,Northern Ireland,1,2,European Championship qual,Estonia,1,-1
848,6/8/2019,Azerbaijan,Hungary,1,3,European Championship qual,Azerbaijan,1,-2
849,6/8/2019,Belgium,Kazakhstan,3,0,European Championship qual,Belgium,1,3
850,6/8/2019,Turkey,France,2,0,European Championship qual,Turkey,1,2
851,6/8/2019,Belarus,Germany,0,2,European Championship qual,Belarus,1,-2
852,6/8/2019,Greece,Italy,0,3,European Championship qual,Greece,1,-3
853,6/8/2019,Finland,Bosnia and Herzegovina,2,0,European Championship qual,Finland,1,2
854,6/8/2019,Russia,San Marino,9,0,European Championship qual,Russia,1,9
855,6/8/2019,Iceland,Albania,1,0,European Championship qual,Iceland,1,1
856,6/8/2019,Moldova,Andorra,1,0,European Championship qual,Moldova,1,1
857,6/8/2019,Armenia,Liechtenstein,3,0,European Championship qual,Armenia,1,3
858,6/9/2019,Japan,El Salvador,2,0,Friendly,Japan,1,2
859,6/9/2019,Turkmenistan,Uganda,0,0,Friendly,United Arab Emirates,0,0
860,6/9/2019,Cameroon,Zambia,2,1,Friendly,Spain,0,1
861,6/9/2019,Burkina Faso,DR Congo,0,0,Friendly,Spain,0,0
862,6/9/2019,Namibia,Ghana,1,0,Friendly,United Arab Emirates,0,1
863,6/9/2019,United States,Venezuela,0,3,Friendly,United States,1,-3
864,6/9/2019,Paraguay,Guatemala,2,0,Friendly,Paraguay,1,2
865,6/9/2019,Mexico,Ecuador,3,2,Friendly,United States,0,1
866,6/9/2019,Brazil,Honduras,7,0,Friendly,Brazil,1,7
867,6/9/2019,Peru,Colombia,0,3,Friendly,Peru,1,-3
868,6/9/2019,England,Switzerland,0,0,European Nations League,Portugal,0,0
869,6/9/2019,Portugal,Netherlands,1,0,European Nations League,Portugal,1,1
870,6/10/2019,Canada,Trinidad and Tobago,2,0,Friendly,United States,0,2
871,6/10/2019,Vanuatu,Fiji,0,0,Friendly tournament,Vanuatu,1,0
872,6/10/2019,North Macedonia,Austria,1,4,European Championship qual,North Macedonia,1,-3
873,6/10/2019,Spain,Sweden,3,0,European Championship qual,Spain,1,3
874,6/10/2019,Faroe Islands,Norway,0,2,European Championship qual,Faroe Islands,1,-2
875,6/10/2019,Ukraine,Luxembourg,1,0,European Championship qual,Ukraine,1,1
876,6/10/2019,Denmark,Georgia,5,1,European Championship qual,Denmark,1,4
877,6/10/2019,Poland,Israel,4,0,European Championship qual,Poland,1,4
878,6/10/2019,Malta,Romania,0,4,European Championship qual,Malta,1,-4
879,6/10/2019,Latvia,Slovenia,0,5,European Championship qual,Latvia,1,-5
880,6/10/2019,Serbia,Lithuania,4,1,European Championship qual,Serbia,1,3
881,6/10/2019,Bulgaria,Kosovo,2,3,European Championship qual,Bulgaria,1,-1
882,6/10/2019,Ireland,Gibraltar,2,0,European Championship qual,Ireland,1,2
883,6/10/2019,Czechia,Montenegro,3,0,European Championship qual,Czechia,1,3
884,6/11/2019,China,Tajikistan,1,0,Friendly,China,1,1
885,6/11/2019,Jordan,Indonesia,4,1,Friendly,Jordan,1,3
886,6/11/2019,South Korea,Iran,1,1,Friendly,South Korea,1,0
887,6/11/2019,Brunei,Mongolia,2,1,World Cup and Asian Cup qual,Brunei,1,1
888,6/11/2019,Uzbekistan,Syria,2,0,Friendly,Uzbekistan,1,2
889,6/11/2019,Hong Kong,Taiwan,0,2,Friendly,Hong Kong,1,-2
890,6/11/2019,Singapore,Myanmar,1,2,Friendly,Singapore,1,-1
891,6/11/2019,Cambodia,Pakistan,2,1,World Cup and Asian Cup qual,Qatar,0,1
892,6/11/2019,Malaysia,East Timor,5,1,World Cup qualifier,Malaysia,1,4
893,6/11/2019,Kyrgyzstan,Palestine,2,2,Friendly,Kyrgyzstan,1,0
894,6/11/2019,Bangladesh,Laos,0,0,World Cup and Asian Cup qual,Bangladesh,1,0
895,6/11/2019,Guam,Bhutan,5,0,World Cup and Asian Cup qual,Guam,1,5
896,6/11/2019,Algeria,Burundi,1,1,Friendly,Qatar,0,0
897,6/11/2019,Croatia,Tunisia,1,2,Friendly,Croatia,1,-1
898,6/11/2019,Benin,Guinea,1,0,Friendly,Morocco,0,1
899,6/11/2019,Haiti,Guyana,3,1,Friendly,Costa Rica,0,2
900,6/11/2019,Belgium,Scotland,3,0,European Championship qual,Belgium,1,3
901,6/11/2019,Hungary,Wales,1,0,European Championship qual,Hungary,1,1
902,6/11/2019,Belarus,Northern Ireland,0,1,European Championship qual,Belarus,1,-1
903,6/11/2019,Andorra,France,0,4,European Championship qual,Andorra,1,-4
904,6/11/2019,Germany,Estonia,8,0,European Championship qual,Germany,1,8
905,6/11/2019,Italy,Bosnia and Herzegovina,2,1,European Championship qual,Italy,1,1
906,6/11/2019,Liechtenstein,Finland,0,2,European Championship qual,Liechtenstein,1,-2
907,6/11/2019,Russia,Cyprus,1,0,European Championship qual,Russia,1,1
908,6/11/2019,Iceland,Turkey,2,1,European Championship qual,Iceland,1,1
909,6/11/2019,Greece,Armenia,2,3,European Championship qual,Greece,1,-1
910,6/11/2019,Azerbaijan,Slovakia,1,5,European Championship qual,Azerbaijan,1,-4
911,6/11/2019,Albania,Moldova,2,0,European Championship qual,Albania,1,2
912,6/11/2019,Kazakhstan,San Marino,4,0,European Championship qual,Kazakhstan,1,4
913,6/12/2019,Morocco,Gambia,0,1,Friendly,Morocco,1,-1
914,6/13/2019,Egypt,Tanzania,1,0,Friendly,Egypt,1,1
915,6/14/2019,Mauritania,Madagascar,3,1,Friendly,Morocco,0,2
916,6/14/2019,Cameroon,Mali,1,1,Friendly,Qatar,0,0
917,6/14/2019,Brazil,Bolivia,3,0,Copa America,Brazil,1,3
918,6/15/2019,Indonesia,Vanuatu,6,0,Friendly,Indonesia,1,6
919,6/15/2019,Ghana,South Africa,0,0,Friendly,United Arab Emirates,0,0
920,6/15/2019,DR Congo,Kenya,1,1,Friendly,Spain,0,0
921,6/15/2019,Uganda,Ivory Coast,1,0,Friendly,United Arab Emirates,0,1
922,6/15/2019,Canada,Martinique,4,0,CONCACAF Championship,United States,0,4
923,6/15/2019,Mexico,Cuba,7,0,CONCACAF Championship,United States,0,7
924,6/15/2019,Colombia,Argentina,2,0,Copa America,Brazil,0,2
925,6/15/2019,Peru,Venezuela,0,0,Copa America,Brazil,0,0
926,6/16/2019,Paraguay,Qatar,2,2,Copa America,Brazil,0,0
927,6/16/2019,Egypt,Guinea,3,1,Friendly,Egypt,1,2
928,6/16/2019,Tanzania,Zimbabwe,1,1,Friendly,Egypt,0,0
929,6/16/2019,Morocco,Zambia,2,3,Friendly,Morocco,1,-1
930,6/16/2019,Senegal,Nigeria,1,0,Friendly,Egypt,0,1
931,6/16/2019,Algeria,Mali,3,2,Friendly,Qatar,0,1
932,6/16/2019,Costa Rica,Nicaragua,4,0,CONCACAF Championship,Costa Rica,1,4
933,6/16/2019,Haiti,Bermuda,2,1,CONCACAF Championship,Costa Rica,0,1
934,6/16/2019,Uruguay,Ecuador,4,0,Copa America,Brazil,0,4
935,6/17/2019,Chile,Japan,4,0,Copa America,Brazil,0,4
936,6/17/2019,Tunisia,Burundi,2,1,Friendly,Tunisia,1,1
937,6/17/2019,El Salvador,Curaçao,1,0,CONCACAF Championship,Jamaica,0,1
938,6/17/2019,Jamaica,Honduras,3,2,CONCACAF Championship,Jamaica,1,1
939,6/18/2019,Benin,Mauritania,3,1,Friendly,Morocco,0,2
940,6/18/2019,United States,Guyana,4,0,CONCACAF Championship,United States,1,4
941,6/18/2019,Panama,Trinidad and Tobago,2,0,CONCACAF Championship,United States,0,2
942,6/18/2019,Brazil,Venezuela,0,0,Copa America,Brazil,1,0
943,6/18/2019,Peru,Bolivia,3,1,Copa America,Brazil,0,2
944,6/19/2019,Colombia,Qatar,1,0,Copa America,Brazil,0,1
945,6/19/2019,Ivory Coast,Zambia,4,1,Friendly,United Arab Emirates,0,3
946,6/19/2019,Mexico,Canada,3,1,CONCACAF Championship,United States,0,2
947,6/19/2019,Martinique,Cuba,3,0,CONCACAF Championship,United States,0,3
948,6/19/2019,Argentina,Paraguay,1,1,Copa America,Brazil,0,0
949,6/20/2019,Japan,Uruguay,2,2,Copa America,Brazil,0,0
950,6/20/2019,Costa Rica,Bermuda,2,1,CONCACAF Championship,United States,0,1
951,6/20/2019,Haiti,Nicaragua,2,0,CONCACAF Championship,United States,0,2
952,6/21/2019,Egypt,Zimbabwe,1,0,African Nations Cup,Egypt,1,1
953,6/21/2019,El Salvador,Jamaica,0,0,CONCACAF Championship,United States,0,0
954,6/21/2019,Curaçao,Honduras,1,0,CONCACAF Championship,United States,0,1
955,6/21/2019,Chile,Ecuador,2,1,Copa America,Brazil,0,1
956,6/22/2019,Uganda,DR Congo,2,0,African Nations Cup,Egypt,0,2
957,6/22/2019,Guinea,Madagascar,2,2,African Nations Cup,Egypt,0,0
958,6/22/2019,Nigeria,Burundi,1,0,African Nations Cup,Egypt,0,1
959,6/22/2019,United States,Trinidad and Tobago,6,0,CONCACAF Championship,United States,1,6
960,6/22/2019,Panama,Guyana,4,2,CONCACAF Championship,United States,0,2
961,6/22/2019,Brazil,Peru,5,0,Copa America,Brazil,1,5
962,6/22/2019,Venezuela,Bolivia,3,1,Copa America,Brazil,0,2
963,6/23/2019,Argentina,Qatar,2,0,Copa America,Brazil,0,2
964,6/23/2019,Algeria,Kenya,2,0,African Nations Cup,Egypt,0,2
965,6/23/2019,Senegal,Tanzania,2,0,African Nations Cup,Egypt,0,2
966,6/23/2019,Morocco,Namibia,1,0,African Nations Cup,Egypt,0,1
967,6/23/2019,Canada,Cuba,7,0,CONCACAF Championship,United States,0,7
968,6/23/2019,Mexico,Martinique,3,2,CONCACAF Championship,United States,0,1
969,6/23/2019,Colombia,Paraguay,1,0,Copa America,Brazil,0,1
970,6/24/2019,Ecuador,Japan,1,1,Copa America,Brazil,0,0
971,6/24/2019,Ivory Coast,South Africa,1,0,African Nations Cup,Egypt,0,1
972,6/24/2019,Angola,Tunisia,1,1,African Nations Cup,Egypt,0,0
973,6/24/2019,Mali,Mauritania,4,1,African Nations Cup,Egypt,0,3
974,6/24/2019,Haiti,Costa Rica,2,1,CONCACAF Championship,United States,0,1
975,6/24/2019,Bermuda,Nicaragua,2,0,CONCACAF Championship,United States,0,2
976,6/24/2019,Uruguay,Chile,1,0,Copa America,Brazil,0,1
977,6/25/2019,Benin,Ghana,2,2,African Nations Cup,Egypt,0,0
978,6/25/2019,Cameroon,Guinea-Bissau,2,0,African Nations Cup,Egypt,0,2
979,6/25/2019,Honduras,El Salvador,4,0,CONCACAF Championship,United States,0,4
980,6/25/2019,Curaçao,Jamaica,1,1,CONCACAF Championship,United States,0,0
981,6/26/2019,Egypt,DR Congo,2,0,African Nations Cup,Egypt,1,2
982,6/26/2019,Uganda,Zimbabwe,1,1,African Nations Cup,Egypt,0,0
983,6/26/2019,Nigeria,Guinea,1,0,African Nations Cup,Egypt,0,1
984,6/26/2019,United States,Panama,1,0,CONCACAF Championship,United States,1,1
985,6/26/2019,Guyana,Trinidad and Tobago,1,1,CONCACAF Championship,United States,0,0
986,6/27/2019,Kenya,Tanzania,3,2,African Nations Cup,Egypt,0,1
987,6/27/2019,Madagascar,Burundi,1,0,African Nations Cup,Egypt,0,1
988,6/27/2019,Algeria,Senegal,1,0,African Nations Cup,Egypt,0,1
989,6/27/2019,Brazil,Paraguay,0,0,Copa America,Brazil,1,0
990,6/28/2019,South Africa,Namibia,1,0,African Nations Cup,Egypt,0,1
991,6/28/2019,Mali,Tunisia,1,1,African Nations Cup,Egypt,0,0
992,6/28/2019,Morocco,Ivory Coast,1,0,African Nations Cup,Egypt,0,1
993,6/28/2019,Argentina,Venezuela,2,0,Copa America,Brazil,0,2
994,6/28/2019,Chile,Colombia,0,0,Copa America,Brazil,0,0
995,6/29/2019,Cameroon,Ghana,0,0,African Nations Cup,Egypt,0,0
996,6/29/2019,Benin,Guinea-Bissau,0,0,African Nations Cup,Egypt,0,0
997,6/29/2019,Angola,Mauritania,0,0,African Nations Cup,Egypt,0,0
998,6/29/2019,Haiti,Canada,3,2,CONCACAF Championship,United States,0,1
999,6/29/2019,Costa Rica,Mexico,1,1,CONCACAF Championship,United States,0,0
1000,6/29/2019,Peru,Uruguay,0,0,Copa America,Brazil,0,0
1001,6/30/2019,Egypt,Uganda,2,0,African Nations Cup,Egypt,1,2
1002,6/30/2019,DR Congo,Zimbabwe,4,0,African Nations Cup,Egypt,0,4
1003,6/30/2019,Madagascar,Nigeria,2,0,African Nations Cup,Egypt,0,2
1004,6/30/2019,Guinea,Burundi,2,0,African Nations Cup,Egypt,0,2
1005,6/30/2019,United States,Curaçao,1,0,CONCACAF Championship,United States,1,1
1006,6/30/2019,Jamaica,Panama,1,0,CONCACAF Championship,United States,0,1
1007,7/1/2019,Morocco,South Africa,1,0,African Nations Cup,Egypt,0,1
1008,7/1/2019,Senegal,Kenya,3,0,African Nations Cup,Egypt,0,3
1009,7/1/2019,Algeria,Tanzania,3,0,African Nations Cup,Egypt,0,3
1010,7/1/2019,Ivory Coast,Namibia,4,1,African Nations Cup,Egypt,0,3
1011,7/2/2019,Ghana,Guinea-Bissau,2,0,African Nations Cup,Egypt,0,2
1012,7/2/2019,Mauritania,Tunisia,0,0,African Nations Cup,Egypt,0,0
1013,7/2/2019,Benin,Cameroon,0,0,African Nations Cup,Egypt,0,0
1014,7/2/2019,Mali,Angola,1,0,African Nations Cup,Egypt,0,1
1015,7/2/2019,Mexico,Haiti,1,0,CONCACAF Championship,United States,0,1
1016,7/2/2019,Brazil,Argentina,2,0,Copa America,Brazil,1,2
1017,7/3/2019,United States,Jamaica,3,1,CONCACAF Championship,United States,1,2
1018,7/3/2019,Peru,Chile,3,0,Copa America,Brazil,0,3
1019,7/5/2019,Senegal,Uganda,1,0,African Nations Cup,Egypt,0,1
1020,7/5/2019,Benin,Morocco,1,1,African Nations Cup,Egypt,0,0
1021,7/6/2019,Egypt,South Africa,0,1,African Nations Cup,Egypt,1,-1
1022,7/6/2019,Nigeria,Cameroon,3,2,African Nations Cup,Egypt,0,1
1023,7/6/2019,Argentina,Chile,2,1,Copa America,Brazil,0,1
1024,7/7/2019,India,Tajikistan,2,4,Friendly tournament,India,1,-2
1025,7/7/2019,DR Congo,Madagascar,2,2,African Nations Cup,Egypt,0,0
1026,7/7/2019,Algeria,Guinea,3,0,African Nations Cup,Egypt,0,3
1027,7/7/2019,United States,Mexico,0,1,CONCACAF Championship,United States,1,-1
1028,7/7/2019,Brazil,Peru,3,1,Copa America,Brazil,1,2
1029,7/8/2019,Syria,North Korea,5,2,Friendly tournament,India,0,3
1030,7/8/2019,Ghana,Tunisia,1,1,African Nations Cup,Egypt,0,0
1031,7/8/2019,Ivory Coast,Mali,1,0,African Nations Cup,Egypt,0,1
1032,7/8/2019,New Caledonia,Eastern Samoa,5,0,Pacific Games,Samoa,0,5
1033,7/8/2019,Fiji,Tahiti,2,1,Pacific Games,Samoa,0,1
1034,7/8/2019,Samoa,Papua New Guinea,0,6,Pacific Games,Samoa,1,-6
1035,7/8/2019,Solomon Islands,Tuvalu,13,0,Pacific Games,Samoa,0,13
1036,7/10/2019,Tajikistan,Syria,2,0,Friendly tournament,India,0,2
1037,7/10/2019,Nigeria,South Africa,2,1,African Nations Cup,Egypt,0,1
1038,7/10/2019,Senegal,Benin,1,0,African Nations Cup,Egypt,0,1
1039,7/10/2019,New Caledonia,Solomon Islands,2,0,Pacific Games,Samoa,0,2
1040,7/10/2019,Papua New Guinea,Vanuatu,2,0,Pacific Games,Samoa,0,2
1041,7/10/2019,Fiji,Eastern Samoa,9,0,Pacific Games,Samoa,0,9
1042,7/10/2019,Tahiti,Tuvalu,7,0,Pacific Games,Samoa,0,7
1043,7/11/2019,Tunisia,Madagascar,3,0,African Nations Cup,Egypt,0,3
1044,7/11/2019,Algeria,Ivory Coast,1,1,African Nations Cup,Egypt,0,0
1045,7/12/2019,New Caledonia,Fiji,1,0,Pacific Games,Samoa,0,1
1046,7/12/2019,Tahiti,Solomon Islands,3,0,Pacific Games,Samoa,0,3
1047,7/12/2019,Samoa,Tonga,2,0,Pacific Games,Samoa,1,2
1048,7/12/2019,Eastern Samoa,Tuvalu,1,1,Pacific Games,Samoa,0,0
1049,7/13/2019,India,North Korea,2,5,Friendly tournament,India,1,-3
1050,7/14/2019,Algeria,Nigeria,2,1,African Nations Cup,Egypt,0,1
1051,7/14/2019,Senegal,Tunisia,1,0,African Nations Cup,Egypt,0,1
1052,7/15/2019,North Korea,Tajikistan,1,0,Friendly tournament,India,0,1
1053,7/15/2019,New Caledonia,Tahiti,3,0,Pacific Games,Samoa,0,3
1054,7/15/2019,Vanuatu,Tonga,14,0,Pacific Games,Samoa,0,14
1055,7/15/2019,Fiji,Tuvalu,10,1,Pacific Games,Samoa,0,9
1056,7/15/2019,Solomon Islands,Eastern Samoa,13,0,Pacific Games,Samoa,0,13
1057,7/16/2019,India,Syria,1,1,Friendly tournament,India,1,0
1058,7/17/2019,Nigeria,Tunisia,1,0,African Nations Cup,Egypt,0,1
1059,7/18/2019,Reunion,Maldives,4,0,Indian Ocean Games,Mauritius,0,4
1060,7/18/2019,Mauritius,Seychelles,1,1,Indian Ocean Games,Mauritius,1,0
1061,7/18/2019,Mayotte,Comoros,2,0,Indian Ocean Games,Mauritius,0,2
1062,7/18/2019,New Caledonia,Tuvalu,11,0,Pacific Games,Samoa,0,11
1063,7/18/2019,Samoa,Vanuatu,0,11,Pacific Games,Samoa,1,-11
1064,7/18/2019,Fiji,Solomon Islands,4,4,Pacific Games,Samoa,0,0
1065,7/18/2019,Tahiti,Eastern Samoa,8,1,Pacific Games,Samoa,0,7
1066,7/18/2019,Papua New Guinea,Tonga,8,0,Pacific Games,Samoa,0,8
1067,7/19/2019,North Korea,Tajikistan,1,0,Friendly tournament,India,0,1
1068,7/19/2019,Algeria,Senegal,1,0,African Nations Cup,Egypt,0,1
1069,7/20/2019,Comoros,Maldives,3,0,Indian Ocean Games,Mauritius,0,3
1070,7/20/2019,Madagascar,Seychelles,0,0,Indian Ocean Games,Mauritius,0,0
1071,7/20/2019,Reunion,Mayotte,1,0,Indian Ocean Games,Mauritius,0,1
1072,7/20/2019,Fiji,Papua New Guinea,1,1,Pacific Games,Samoa,0,0
1073,7/22/2019,Mayotte,Maldives,3,1,Indian Ocean Games,Mauritius,0,2
1074,7/22/2019,Mauritius,Madagascar,1,1,Indian Ocean Games,Mauritius,1,0
1075,7/22/2019,Comoros,Reunion,1,0,Indian Ocean Games,Mauritius,0,1
1076,7/22/2019,Djibouti,Somalia,1,0,Friendly,Djibouti,1,1
1077,7/24/2019,Mauritius,Mayotte,1,0,Indian Ocean Games,Mauritius,1,1
1078,7/24/2019,Reunion,Seychelles,4,0,Indian Ocean Games,Mauritius,0,4
1079,7/26/2019,Mayotte,Seychelles,3,1,Indian Ocean Games,Mauritius,0,2
1080,7/28/2019,Mauritius,Reunion,1,1,Indian Ocean Games,Mauritius,1,0
1081,7/30/2019,Iraq,Lebanon,1,0,West Asian Championship,Iraq,1,1
1082,7/30/2019,Palestine,Yemen,1,0,West Asian Championship,Iraq,0,1
1083,8/2/2019,Lebanon,Syria,2,1,West Asian Championship,Iraq,0,1
1084,8/2/2019,Iraq,Palestine,2,1,West Asian Championship,Iraq,1,1
1085,8/4/2019,Kuwait,Saudi Arabia,2,1,West Asian Championship,Iraq,0,1
1086,8/4/2019,Bahrain,Jordan,1,0,West Asian Championship,Iraq,0,1
1087,8/5/2019,Lebanon,Palestine,0,0,West Asian Championship,Iraq,0,0
1088,8/5/2019,Syria,Yemen,1,1,West Asian Championship,Iraq,0,0
1089,8/7/2019,Jordan,Kuwait,1,1,West Asian Championship,Iraq,0,0
1090,8/7/2019,Bahrain,Saudi Arabia,0,0,West Asian Championship,Iraq,0,0
1091,8/8/2019,Yemen,Lebanon,2,1,West Asian Championship,Iraq,0,1
1092,8/8/2019,Iraq,Syria,0,0,West Asian Championship,Iraq,1,0
1093,8/10/2019,Bahrain,Kuwait,1,0,West Asian Championship,Iraq,0,1
1094,8/10/2019,Jordan,Saudi Arabia,3,0,West Asian Championship,Iraq,0,3
1095,8/11/2019,Palestine,Syria,4,3,West Asian Championship,Iraq,0,1
1096,8/11/2019,Iraq,Yemen,2,1,West Asian Championship,Iraq,1,1
1097,8/11/2019,St Vincent & Grenadines,Trinidad and Tobago,1,0,Friendly,St Vincent & Grenadines,1,1
1098,8/14/2019,Iraq,Bahrain,0,1,West Asian Championship,Iraq,1,-1
1099,8/14/2019,Dominican Republic,Guatemala,0,0,Friendly,Dominican Republic,1,0
1100,8/18/2019,Sint Maarten,Anguilla,2,0,Friendly,Sint Maarten,1,2
1101,8/25/2019,Saint Kitts and Nevis,Antigua and Barbuda,3,0,Friendly,Saint Kitts and Nevis,1,3
1102,8/27/2019,Saint Kitts and Nevis,Antigua and Barbuda,4,3,Friendly,Saint Kitts and Nevis,1,1
1103,8/28/2019,Oman,Yemen,1,0,Friendly,Oman,1,1
1104,8/29/2019,Taiwan,Guam,3,0,Friendly,Taiwan,1,3
1105,8/30/2019,China,Myanmar,4,1,Friendly,China,1,3
1106,8/30/2019,Malaysia,Jordan,0,1,Friendly,Malaysia,1,-1
1107,8/30/2019,United Arab Emirates,Dominican Republic,4,0,Friendly,Bahrain,0,4
1108,8/30/2019,Belize,St Vincent & Grenadines,1,1,Friendly,Belize,1,0
1109,8/31/2019,United Arab Emirates,Sri Lanka,5,1,Friendly,Bahrain,0,4
1110,9/1/2019,Belize,St Vincent & Grenadines,1,0,Friendly,Belize,1,1
1111,9/4/2019,Burundi,Tanzania,1,1,World Cup qualifier,Burundi,1,0
1112,9/4/2019,Mauritius,Mozambique,0,1,World Cup qualifier,Mauritius,1,-1
1113,9/4/2019,Djibouti,Eswatini,2,1,World Cup qualifier,Djibouti,1,1
1114,9/4/2019,Ethiopia,Lesotho,0,0,World Cup qualifier,Ethiopia,1,0
1115,9/4/2019,Liberia,Sierra Leone,3,1,World Cup qualifier,Liberia,1,2
1116,9/4/2019,São Tomé and Príncipe,Guinea-Bissau,0,1,World Cup qualifier,São Tomé and Príncipe,1,-1
1117,9/4/2019,Burkina Faso,Libya,1,0,Friendly,Morocco,0,1
1118,9/4/2019,Equatorial Guinea,South Sudan,1,1,World Cup qualifier,Sudan,0,0
1119,9/4/2019,Eritrea,Namibia,1,2,World Cup qualifier,Eritrea,1,-1
1120,9/5/2019,Japan,Paraguay,2,0,Friendly,Japan,1,2
1121,9/5/2019,Philippines,Syria,2,5,World Cup and Asian Cup qual,Philippines,1,-3
1122,9/5/2019,Indonesia,Malaysia,2,3,World Cup and Asian Cup qual,Indonesia,1,-1
1123,9/5/2019,India,Oman,1,2,World Cup and Asian Cup qual,India,1,-1
1124,9/5/2019,North Korea,Lebanon,2,0,World Cup and Asian Cup qual,North Korea,1,2
1125,9/5/2019,Qatar,Afghanistan,6,0,World Cup and Asian Cup qual,Qatar,1,6
1126,9/5/2019,Mongolia,Myanmar,1,0,World Cup and Asian Cup qual,Mongolia,1,1
1127,9/5/2019,Georgia,South Korea,2,2,Friendly,Turkey,0,0
1128,9/5/2019,Thailand,Vietnam,0,0,World Cup and Asian Cup qual,Thailand,1,0
1129,9/5/2019,Taiwan,Jordan,1,2,World Cup and Asian Cup qual,Taiwan,1,-1
1130,9/5/2019,Sri Lanka,Turkmenistan,0,2,World Cup and Asian Cup qual,Sri Lanka,1,-2
1131,9/5/2019,Cambodia,Hong Kong,1,1,World Cup and Asian Cup qual,Cambodia,1,0
1132,9/5/2019,Singapore,Yemen,2,2,World Cup and Asian Cup qual,Singapore,1,0
1133,9/5/2019,Tajikistan,Kyrgyzstan,1,0,World Cup and Asian Cup qual,Tajikistan,1,1
1134,9/5/2019,Bahrain,Iraq,1,1,World Cup and Asian Cup qual,Bahrain,1,0
1135,9/5/2019,Kuwait,Nepal,7,0,World Cup and Asian Cup qual,Kuwait,1,7
1136,9/5/2019,Saudi Arabia,Mali,1,1,Friendly,Saudi Arabia,1,0
1137,9/5/2019,Palestine,Uzbekistan,2,0,World Cup and Asian Cup qual,Palestine,1,2
1138,9/5/2019,Guam,Maldives,0,1,World Cup and Asian Cup qual,Guam,1,-1
1139,9/5/2019,Somalia,Zimbabwe,1,0,World Cup qualifier,Djibouti,0,1
1140,9/5/2019,Chad,Sudan,1,3,World Cup qualifier,Chad,1,-2
1141,9/5/2019,Seychelles,Rwanda,0,3,World Cup qualifier,Seychelles,1,-3
1142,9/5/2019,Guatemala,Anguilla,10,0,CONCACAF Nations League C,Guatemala,1,10
1143,9/5/2019,Honduras,Puerto Rico,4,0,Friendly,Honduras,1,4
1144,9/5/2019,Barbados,Saint Martin,4,0,CONCACAF Nations League C,Barbados,1,4
1145,9/5/2019,Nicaragua,St Vincent & Grenadines,1,1,CONCACAF Nations League B,Nicaragua,1,0
1146,9/5/2019,Dominica,Suriname,1,2,CONCACAF Nations League B,Dominica,1,-1
1147,9/5/2019,Grenada,Saint Kitts and Nevis,2,1,CONCACAF Nations League B,Grenada,1,1
1148,9/5/2019,Bermuda,Panama,1,4,CONCACAF Nations League A,Bermuda,1,-3
1149,9/5/2019,US Virgin Islands,Cayman Islands,0,2,CONCACAF Nations League C,US Virgin Islands,1,-2
1150,9/5/2019,Argentina,Chile,0,0,Friendly,United States,0,0
1151,9/5/2019,Ecuador,Peru,1,0,Friendly,United States,0,1
1152,9/5/2019,Northern Ireland,Luxembourg,1,0,Friendly,Northern Ireland,1,1
1153,9/5/2019,Montenegro,Hungary,2,1,Friendly,Montenegro,1,1
1154,9/5/2019,Ireland,Switzerland,1,1,European Championship qual,Ireland,1,0
1155,9/5/2019,Faroe Islands,Sweden,0,4,European Championship qual,Faroe Islands,1,-4
1156,9/5/2019,Norway,Malta,2,0,European Championship qual,Norway,1,2
1157,9/5/2019,Armenia,Italy,1,3,European Championship qual,Armenia,1,-2
1158,9/5/2019,Finland,Greece,1,0,European Championship qual,Finland,1,1
1159,9/5/2019,Gibraltar,Denmark,0,6,European Championship qual,Gibraltar,1,-6
1160,9/5/2019,Romania,Spain,1,2,European Championship qual,Romania,1,-1
1161,9/5/2019,Israel,North Macedonia,1,1,European Championship qual,Israel,1,0
1162,9/5/2019,Bosnia and Herzegovina,Liechtenstein,5,0,European Championship qual,Bosnia and Herzegovina,1,5
1163,9/6/2019,Gambia,Angola,0,1,World Cup qualifier,The Gambia,0,-1
1164,9/6/2019,Comoros,Togo,1,1,World Cup qualifier,Comoros,1,0
1165,9/6/2019,Tunisia,Mauritania,1,0,Friendly,Tunisia,1,1
1166,9/6/2019,Morocco,Burkina Faso,1,1,Friendly,Morocco,1,0
1167,9/6/2019,Benin,Ivory Coast,2,1,Friendly,France,0,1
1168,9/6/2019,United States,Mexico,0,3,Friendly,United States,1,-3
1169,9/6/2019,Costa Rica,Uruguay,1,2,Friendly,Costa Rica,1,-1
1170,9/6/2019,Guyana,Aruba,1,0,CONCACAF Nations League B,Curaçao,0,1
1171,9/6/2019,Jamaica,Antigua and Barbuda,6,0,CONCACAF Nations League B,Jamaica,1,6
1172,9/6/2019,Martinique,Trinidad and Tobago,1,1,CONCACAF Nations League A,Martinique,1,0
1173,9/6/2019,Bonaire,British Virgin Islands,4,2,CONCACAF Nations League C,Curaçao,0,2
1174,9/6/2019,Brazil,Colombia,2,2,Friendly,United States,0,0
1175,9/6/2019,Scotland,Russia,1,2,European Championship qual,Scotland,1,-1
1176,9/6/2019,Wales,Azerbaijan,2,1,European Championship qual,Wales,1,1
1177,9/6/2019,Austria,Latvia,6,0,European Championship qual,Austria,1,6
1178,9/6/2019,San Marino,Belgium,0,4,European Championship qual,San Marino,1,-4
1179,9/6/2019,Germany,Netherlands,2,4,European Championship qual,Germany,1,-2
1180,9/6/2019,Estonia,Belarus,1,2,European Championship qual,Estonia,1,-1
1181,9/6/2019,Slovenia,Poland,2,0,European Championship qual,Slovenia,1,2
1182,9/6/2019,Slovakia,Croatia,0,4,European Championship qual,Slovakia,1,-4
1183,9/6/2019,Cyprus,Kazakhstan,1,1,European Championship qual,Cyprus,1,0
1184,9/7/2019,Libya,Niger,2,0,Friendly,Morocco,0,2
1185,9/7/2019,Botswana,Malawi,0,0,World Cup qualifier,Botswana,1,0
1186,9/7/2019,Canada,Cuba,6,0,CONCACAF Nations League A,Canada,1,6
1187,9/7/2019,El Salvador,Saint Lucia,3,0,CONCACAF Nations League B,El Salvador,1,3
1188,9/7/2019,Curaçao,Haiti,1,0,CONCACAF Nations League A,Curaçao,1,1
1189,9/7/2019,Guadeloupe,Sint Maarten,5,1,CONCACAF Nations League C,Guadeloupe,1,4
1190,9/7/2019,Montserrat,Dominican Republic,2,1,CONCACAF Nations League B,Montserrat,1,1
1191,9/7/2019,England,Bulgaria,4,0,European Championship qual,England,1,4
1192,9/7/2019,France,Albania,4,1,European Championship qual,France,1,3
1193,9/7/2019,Serbia,Portugal,2,4,European Championship qual,Serbia,1,-2
1194,9/7/2019,Lithuania,Ukraine,0,3,European Championship qual,Lithuania,1,-3
1195,9/7/2019,Turkey,Andorra,1,0,European Championship qual,Turkey,1,1
1196,9/7/2019,Iceland,Moldova,3,0,European Championship qual,Iceland,1,3
1197,9/7/2019,Kosovo,Czechia,2,1,European Championship qual,Kosovo,1,1
1198,9/8/2019,Kenya,Uganda,1,1,Friendly,Kenya,1,0
1199,9/8/2019,Tanzania,Burundi,1,1,World Cup qualifier,Tanzania,1,0
1200,9/8/2019,Lesotho,Ethiopia,1,1,World Cup qualifier,Lesotho,1,0
1201,9/8/2019,Sierra Leone,Liberia,1,0,World Cup qualifier,Sierra Leone,1,1
1202,9/8/2019,Equatorial Guinea,South Sudan,1,0,World Cup qualifier,Equatorial Guinea,1,1
1203,9/8/2019,Cayman Islands,Barbados,3,2,CONCACAF Nations League C,Cayman Islands,1,1
1204,9/8/2019,Suriname,Nicaragua,6,0,CONCACAF Nations League B,Suriname,1,6
1205,9/8/2019,St Vincent & Grenadines,Dominica,1,0,CONCACAF Nations League B,St Vincent & Grenadines,1,1
1206,9/8/2019,Saint Kitts and Nevis,French Guiana,2,2,CONCACAF Nations League B,Saint Kitts and Nevis,1,0
1207,9/8/2019,Belize,Grenada,1,2,CONCACAF Nations League B,Belize,1,-1
1208,9/8/2019,Panama,Bermuda,0,2,CONCACAF Nations League A,Panama,1,-2
1209,9/8/2019,US Virgin Islands,Saint Martin,2,1,CONCACAF Nations League C,Anguilla,0,1
1210,9/8/2019,Switzerland,Gibraltar,4,0,European Championship qual,Switzerland,1,4
1211,9/8/2019,Sweden,Norway,1,1,European Championship qual,Sweden,1,0
1212,9/8/2019,Finland,Italy,1,2,European Championship qual,Finland,1,-1
1213,9/8/2019,Georgia,Denmark,0,0,European Championship qual,Georgia,1,0
1214,9/8/2019,Spain,Faroe Islands,4,0,European Championship qual,Spain,1,4
1215,9/8/2019,Romania,Malta,1,0,European Championship qual,Romania,1,1
1216,9/8/2019,Greece,Liechtenstein,1,1,European Championship qual,Greece,1,0
1217,9/8/2019,Armenia,Bosnia and Herzegovina,4,2,European Championship qual,Armenia,1,2
1218,9/9/2019,Iraq,Uzbekistan,0,0,Friendly,Jordan,0,0
1219,9/9/2019,Algeria,Benin,1,0,Friendly,Algeria,1,1
1220,9/9/2019,Antigua and Barbuda,Aruba,2,1,CONCACAF Nations League B,Antigua and Barbuda,1,1
1221,9/9/2019,Guyana,Jamaica,0,4,CONCACAF Nations League B,Guyana,1,-4
1222,9/9/2019,Trinidad and Tobago,Martinique,2,2,CONCACAF Nations League A,Trinidad and Tobago,1,0
1223,9/9/2019,Bahamas,Bonaire,2,1,CONCACAF Nations League C,Bahamas,1,1
1224,9/9/2019,Scotland,Belgium,0,4,European Championship qual,Scotland,1,-4
1225,9/9/2019,Wales,Belarus,1,0,Friendly,Wales,1,1
1226,9/9/2019,Northern Ireland,Germany,0,2,European Championship qual,Northern Ireland,1,-2
1227,9/9/2019,Poland,Austria,0,0,European Championship qual,Poland,1,0
1228,9/9/2019,Hungary,Slovakia,1,2,European Championship qual,Hungary,1,-1
1229,9/9/2019,Estonia,Netherlands,0,4,European Championship qual,Estonia,1,-4
1230,9/9/2019,Russia,Kazakhstan,1,0,European Championship qual,Russia,1,1
1231,9/9/2019,Latvia,North Macedonia,0,2,European Championship qual,Latvia,1,-2
1232,9/9/2019,Slovenia,Israel,3,2,European Championship qual,Slovenia,1,1
1233,9/9/2019,Azerbaijan,Croatia,1,1,European Championship qual,Azerbaijan,1,0
1234,9/9/2019,San Marino,Cyprus,0,4,European Championship qual,San Marino,1,-4
1235,9/10/2019,Myanmar,Japan,0,2,World Cup and Asian Cup qual,Myanmar,1,-2
1236,9/10/2019,Guam,Philippines,1,4,World Cup and Asian Cup qual,Guam,1,-3
1237,9/10/2019,Kuwait,Australia,0,3,World Cup and Asian Cup qual,Kuwait,1,-3
1238,9/10/2019,Maldives,China,0,5,World Cup and Asian Cup qual,Maldives,1,-5
1239,9/10/2019,Indonesia,Thailand,0,3,World Cup and Asian Cup qual,Indonesia,1,-3
1240,9/10/2019,Qatar,India,0,0,World Cup and Asian Cup qual,Qatar,1,0
1241,9/10/2019,Oman,Lebanon,1,0,Friendly,Oman,1,1
1242,9/10/2019,Afghanistan,Bangladesh,1,0,World Cup and Asian Cup qual,Tajikistan,0,1
1243,9/10/2019,Hong Kong,Iran,0,2,World Cup and Asian Cup qual,Hong Kong,1,-2
1244,9/10/2019,Mongolia,Tajikistan,0,1,World Cup and Asian Cup qual,Mongolia,1,-1
1245,9/10/2019,Turkmenistan,South Korea,0,2,World Cup and Asian Cup qual,Turkmenistan,1,-2
1246,9/10/2019,Taiwan,Nepal,0,2,World Cup and Asian Cup qual,Taiwan,1,-2
1247,9/10/2019,Sri Lanka,North Korea,0,1,World Cup and Asian Cup qual,Sri Lanka,1,-1
1248,9/10/2019,Singapore,Palestine,2,1,World Cup and Asian Cup qual,Singapore,1,1
1249,9/10/2019,Malaysia,United Arab Emirates,1,2,World Cup and Asian Cup qual,Malaysia,1,-1
1250,9/10/2019,Cambodia,Bahrain,0,1,World Cup and Asian Cup qual,Cambodia,1,-1
1251,9/10/2019,Jordan,Paraguay,2,4,Friendly,Jordan,1,-2
1252,9/10/2019,Saudi Arabia,Yemen,2,2,World Cup and Asian Cup qual,Bahrain,0,0
1253,9/10/2019,Zimbabwe,Somalia,3,1,World Cup qualifier,Zimbabwe,1,2
1254,9/10/2019,Mozambique,Mauritius,2,0,World Cup qualifier,Mozambique,1,2
1255,9/10/2019,Eswatini,Djibouti,0,0,World Cup qualifier,Eswatini,1,0
1256,9/10/2019,Ukraine,Nigeria,2,2,Friendly,Ukraine,1,0
1257,9/10/2019,Angola,Gambia,2,1,World Cup qualifier,Angola,1,1
1258,9/10/2019,Guinea-Bissau,São Tomé and Príncipe,2,1,World Cup qualifier,Guinea-Bissau,1,1
1259,9/10/2019,Togo,Comoros,2,0,World Cup qualifier,Togo,1,2
1260,9/10/2019,Sudan,Chad,0,0,World Cup qualifier,Sudan,1,0
1261,9/10/2019,Ivory Coast,Tunisia,2,1,Friendly,France,0,1
1262,9/10/2019,Malawi,Botswana,1,0,World Cup qualifier,Malawi,1,1
1263,9/10/2019,Morocco,Niger,1,0,Friendly,Morocco,1,1
1264,9/10/2019,Rwanda,Seychelles,7,0,World Cup qualifier,Rwanda,1,7
1265,9/10/2019,Namibia,Eritrea,2,0,World Cup qualifier,Namibia,1,2
1266,9/10/2019,United States,Uruguay,1,1,Friendly,United States,1,0
1267,9/10/2019,Canada,Cuba,1,0,CONCACAF Nations League A,Cayman Islands,0,1
1268,9/10/2019,Dominican Republic,El Salvador,1,0,CONCACAF Nations League B,Dominican Republic,1,1
1269,9/10/2019,Puerto Rico,Guatemala,0,5,CONCACAF Nations League C,Puerto Rico,1,-5
1270,9/10/2019,Argentina,Mexico,4,0,Friendly,United States,0,4
1271,9/10/2019,Haiti,Curaçao,1,1,CONCACAF Nations League A,Haiti,1,0
1272,9/10/2019,Honduras,Chile,2,1,Friendly,Honduras,1,1
1273,9/10/2019,Turks and Caicos Islands,Guadeloupe,0,3,CONCACAF Nations League C,Turks and Caicos Islands,1,-3
1274,9/10/2019,Montserrat,Saint Lucia,1,1,CONCACAF Nations League B,Montserrat,1,0
1275,9/10/2019,Peru,Brazil,1,0,Friendly,United States,0,1
1276,9/10/2019,Ecuador,Bolivia,3,0,Friendly,Ecuador,1,3
1277,9/10/2019,Colombia,Venezuela,0,0,Friendly,United States,0,0
1278,9/10/2019,England,Kosovo,5,3,European Championship qual,England,1,2
1279,9/10/2019,France,Andorra,3,0,European Championship qual,France,1,3
1280,9/10/2019,Luxembourg,Serbia,1,3,European Championship qual,Luxembourg,1,-2
1281,9/10/2019,Lithuania,Portugal,1,5,European Championship qual,Lithuania,1,-4
1282,9/10/2019,Moldova,Turkey,0,4,European Championship qual,Moldova,1,-4
1283,9/10/2019,Ireland,Bulgaria,3,1,Friendly,Ireland,1,2
1284,9/10/2019,Albania,Iceland,4,2,European Championship qual,Albania,1,2
1285,9/10/2019,Montenegro,Czechia,0,3,European Championship qual,Montenegro,1,-3
1286,9/29/2019,Bangladesh,Bhutan,4,1,Friendly,Bangladesh,1,3
1287,9/30/2019,Botswana,Liberia,0,0,Friendly,Botswana,1,0
1288,10/2/2019,Mexico,Trinidad and Tobago,2,0,Friendly,Mexico,1,2
1289,10/2/2019,Dominican Republic,Cuba,0,0,Friendly,Dominican Republic,1,0
1290,10/3/2019,Bangladesh,Bhutan,2,0,Friendly,Bangladesh,1,2
1291,10/4/2019,Saint Lucia,Dominica,3,1,Friendly,Saint Lucia,1,2
1292,10/5/2019,Malaysia,Sri Lanka,6,0,Friendly,Malaysia,1,6
1293,10/5/2019,Jordan,Singapore,0,0,Friendly,Jordan,1,0
1294,10/6/2019,Saint Lucia,Dominica,1,4,Friendly,Saint Lucia,1,-3
1295,10/9/2019,Bahrain,Azerbaijan,2,3,Friendly,Bahrain,1,-1
1296,10/9/2019,Mauritius,São Tomé and Príncipe,1,3,African Nations Cup qualifier,Mauritius,1,-2
1297,10/9/2019,Djibouti,Gambia,1,1,African Nations Cup qualifier,Djibouti,1,0
1298,10/9/2019,Liberia,Chad,1,0,African Nations Cup qualifier,Liberia,1,1
1299,10/9/2019,South Sudan,Seychelles,2,1,African Nations Cup qualifier,Sudan,0,1
1300,10/9/2019,Germany,Argentina,2,2,Friendly,Germany,1,0
1301,10/10/2019,Japan,Mongolia,6,0,World Cup and Asian Cup qual,Japan,1,6
1302,10/10/2019,Australia,Nepal,5,0,World Cup and Asian Cup qual,Australia,1,5
1303,10/10/2019,China,Guam,7,0,World Cup and Asian Cup qual,China,1,7
1304,10/10/2019,United Arab Emirates,Indonesia,5,0,World Cup and Asian Cup qual,United Arab Emirates,1,5
1305,10/10/2019,Lebanon,Turkmenistan,2,1,World Cup and Asian Cup qual,Lebanon,1,1
1306,10/10/2019,Oman,Afghanistan,3,0,World Cup and Asian Cup qual,Oman,1,3
1307,10/10/2019,Iran,Cambodia,14,0,World Cup and Asian Cup qual,Iran,1,14
1308,10/10/2019,South Korea,Sri Lanka,8,0,World Cup and Asian Cup qual,South Korea,1,8
1309,10/10/2019,Vietnam,Malaysia,1,0,World Cup and Asian Cup qual,Vietnam,1,1
1310,10/10/2019,Syria,Maldives,2,1,World Cup and Asian Cup qual,United Arab Emirates,0,1
1311,10/10/2019,Kyrgyzstan,Myanmar,7,0,World Cup and Asian Cup qual,Kyrgyzstan,1,7
1312,10/10/2019,Iraq,Hong Kong,2,0,World Cup and Asian Cup qual,Iraq,1,2
1313,10/10/2019,Saudi Arabia,Singapore,3,0,World Cup and Asian Cup qual,Saudi Arabia,1,3
1314,10/10/2019,Thailand,Congo,1,1,Friendly,Thailand,1,0
1315,10/10/2019,Jordan,Kuwait,0,0,World Cup and Asian Cup qual,Jordan,1,0
1316,10/10/2019,Uzbekistan,Yemen,5,0,World Cup and Asian Cup qual,Uzbekistan,1,5
1317,10/10/2019,Bangladesh,Qatar,0,2,World Cup and Asian Cup qual,Bangladesh,1,-2
1318,10/10/2019,Niger,Zambia,1,1,Friendly,Niger,1,0
1319,10/10/2019,Algeria,DR Congo,1,1,Friendly,Algeria,1,0
1320,10/10/2019,Cape Verde,Togo,2,1,Friendly,France,0,1
1321,10/10/2019,Gabon,Burkina Faso,1,0,Friendly,France,0,1
1322,10/10/2019,Brazil,Senegal,1,1,Friendly,Singapore,0,0
1323,10/10/2019,Costa Rica,Haiti,1,1,CONCACAF Nations League A,Bahamas,0,0
1324,10/10/2019,Trinidad and Tobago,Honduras,0,2,CONCACAF Nations League A,Trinidad and Tobago,1,-2
1325,10/10/2019,French Guiana,Grenada,0,0,CONCACAF Nations League B,French Guiana,1,0
1326,10/10/2019,Belize,Saint Kitts and Nevis,0,4,CONCACAF Nations League B,Belize,1,-4
1327,10/10/2019,Bahamas,British Virgin Islands,4,0,CONCACAF Nations League C,Saint Kitts and Nevis,0,4
1328,10/10/2019,Turks and Caicos Islands,Sint Maarten,5,2,CONCACAF Nations League C,Curaçao,0,3
1329,10/10/2019,Serbia,Paraguay,1,0,Friendly,Serbia,1,1
1330,10/10/2019,Venezuela,Bolivia,4,1,Friendly,Venezuela,1,3
1331,10/10/2019,Russia,Scotland,4,0,European Championship qual,Russia,1,4
1332,10/10/2019,Slovakia,Wales,1,1,European Championship qual,Slovakia,1,0
1333,10/10/2019,Netherlands,Northern Ireland,3,1,European Championship qual,Netherlands,1,2
1334,10/10/2019,Austria,Israel,3,1,European Championship qual,Austria,1,2
1335,10/10/2019,Croatia,Hungary,3,0,European Championship qual,Croatia,1,3
1336,10/10/2019,Belgium,San Marino,9,0,European Championship qual,Belgium,1,9
1337,10/10/2019,Belarus,Estonia,0,0,European Championship qual,Belarus,1,0
1338,10/10/2019,Latvia,Poland,0,3,European Championship qual,Latvia,1,-3
1339,10/10/2019,Kazakhstan,Cyprus,1,2,European Championship qual,Kazakhstan,1,-1
1340,10/10/2019,North Macedonia,Slovenia,2,1,European Championship qual,North Macedonia,1,1
1341,10/10/2019,Kosovo,Gibraltar,1,0,Friendly,Kosovo,1,1
1342,10/11/2019,Morocco,Libya,1,1,Friendly,Morocco,1,0
1343,10/11/2019,United States,Cuba,7,0,CONCACAF Nations League A,United States,1,7
1344,10/11/2019,Bermuda,Mexico,1,5,CONCACAF Nations League A,Bermuda,1,-4
1345,10/11/2019,Antigua and Barbuda,Guyana,2,1,CONCACAF Nations League B,Antigua and Barbuda,1,1
1346,10/11/2019,Nicaragua,Dominica,3,1,CONCACAF Nations League B,Nicaragua,1,2
1347,10/11/2019,St Vincent & Grenadines,Suriname,2,2,CONCACAF Nations League B,St Vincent & Grenadines,1,0
1348,10/11/2019,Uruguay,Peru,1,0,Friendly,Uruguay,1,1
1349,10/11/2019,Czechia,England,2,1,European Championship qual,Czechia,1,1
1350,10/11/2019,Iceland,France,0,1,European Championship qual,Iceland,1,-1
1351,10/11/2019,Portugal,Luxembourg,3,0,European Championship qual,Portugal,1,3
1352,10/11/2019,Ukraine,Lithuania,2,0,European Championship qual,Ukraine,1,2
1353,10/11/2019,Turkey,Albania,1,0,European Championship qual,Turkey,1,1
1354,10/11/2019,Montenegro,Bulgaria,0,0,European Championship qual,Montenegro,1,0
1355,10/11/2019,Andorra,Moldova,1,0,European Championship qual,Andorra,1,1
1356,10/12/2019,Tunisia,Cameroon,0,0,Friendly,Tunisia,1,0
1357,10/12/2019,Comoros,Guinea,1,0,Friendly,France,0,1
1358,10/12/2019,Montserrat,El Salvador,0,2,CONCACAF Nations League B,Montserrat,1,-2
1359,10/12/2019,Anguilla,Guatemala,0,5,CONCACAF Nations League C,Anguilla,1,-5
1360,10/12/2019,Jamaica,Aruba,2,0,CONCACAF Nations League B,Jamaica,1,2
1361,10/12/2019,Barbados,US Virgin Islands,1,0,CONCACAF Nations League C,Barbados,1,1
1362,10/12/2019,Dominican Republic,Saint Lucia,3,0,CONCACAF Nations League B,Dominican Republic,1,3
1363,10/12/2019,Saint Martin,Cayman Islands,3,0,CONCACAF Nations League C,Anguilla,0,3
1364,10/12/2019,Chile,Colombia,0,0,Friendly,Spain,0,0
1365,10/12/2019,Denmark,Switzerland,1,0,European Championship qual,Denmark,1,1
1366,10/12/2019,Malta,Sweden,0,4,European Championship qual,Malta,1,-4
1367,10/12/2019,Norway,Spain,1,1,European Championship qual,Norway,1,0
1368,10/12/2019,Italy,Greece,2,0,European Championship qual,Italy,1,2
1369,10/12/2019,Bosnia and Herzegovina,Finland,4,1,European Championship qual,Bosnia and Herzegovina,1,3
1370,10/12/2019,Faroe Islands,Romania,0,3,European Championship qual,Faroe Islands,1,-3
1371,10/12/2019,Georgia,Ireland,0,0,European Championship qual,Georgia,1,0
1372,10/12/2019,Liechtenstein,Armenia,1,1,European Championship qual,Liechtenstein,1,0
1373,10/13/2019,South Africa,Mali,2,1,Friendly tournament,South Africa,1,1
1374,10/13/2019,Kenya,Mozambique,0,1,Friendly,Kenya,1,-1
1375,10/13/2019,Ethiopia,Uganda,0,1,Friendly,Ethiopia,1,-1
1376,10/13/2019,Benin,Zambia,2,2,Friendly,Benin,1,0
1377,10/13/2019,São Tomé and Príncipe,Mauritius,2,1,African Nations Cup qualifier,São Tomé and Príncipe,1,1
1378,10/13/2019,Gambia,Djibouti,1,1,African Nations Cup qualifier,The Gambia,0,0
1379,10/13/2019,Ivory Coast,DR Congo,3,1,Friendly,France,0,2
1380,10/13/2019,Brazil,Nigeria,1,1,Friendly,Singapore,0,0
1381,10/13/2019,Equatorial Guinea,Togo,1,1,Friendly,France,0,0
1382,10/13/2019,Lesotho,Malawi,1,1,Friendly,Lesotho,1,0
1383,10/13/2019,Niger,Central African Republic,0,2,Friendly,Niger,1,-2
1384,10/13/2019,Chad,Liberia,1,0,African Nations Cup qualifier,Chad,1,1
1385,10/13/2019,Seychelles,South Sudan,0,1,African Nations Cup qualifier,Seychelles,1,-1
1386,10/13/2019,Costa Rica,Curaçao,0,0,CONCACAF Nations League A,Costa Rica,1,0
1387,10/13/2019,Honduras,Martinique,1,0,CONCACAF Nations League A,Honduras,1,1
1388,10/13/2019,Grenada,French Guiana,1,0,CONCACAF Nations League B,Grenada,1,1
1389,10/13/2019,Saint Kitts and Nevis,Belize,0,1,CONCACAF Nations League B,Saint Kitts and Nevis,1,-1
1390,10/13/2019,Bonaire,British Virgin Islands,4,3,CONCACAF Nations League C,Saint Kitts and Nevis,0,1
1391,10/13/2019,Argentina,Ecuador,6,1,Friendly,Spain,0,5
1392,10/13/2019,Slovakia,Paraguay,1,1,Friendly,Slovakia,1,0
1393,10/13/2019,Scotland,San Marino,6,0,European Championship qual,Scotland,1,6
1394,10/13/2019,Wales,Croatia,1,1,European Championship qual,Wales,1,0
1395,10/13/2019,Slovenia,Austria,0,1,European Championship qual,Slovenia,1,-1
1396,10/13/2019,Hungary,Azerbaijan,1,0,European Championship qual,Hungary,1,1
1397,10/13/2019,Kazakhstan,Belgium,0,2,European Championship qual,Kazakhstan,1,-2
1398,10/13/2019,Belarus,Netherlands,1,2,European Championship qual,Belarus,1,-1
1399,10/13/2019,Estonia,Germany,0,3,European Championship qual,Estonia,1,-3
1400,10/13/2019,Cyprus,Russia,0,5,European Championship qual,Cyprus,1,-5
1401,10/13/2019,Poland,North Macedonia,2,0,European Championship qual,Poland,1,2
1402,10/14/2019,Egypt,Botswana,1,0,Friendly,Egypt,1,1
1403,10/14/2019,Rwanda,Tanzania,0,0,Friendly,Rwanda,1,0
1404,10/14/2019,Guyana,Antigua and Barbuda,5,1,CONCACAF Nations League B,Guyana,1,4
1405,10/14/2019,Venezuela,Trinidad and Tobago,2,0,Friendly,Venezuela,1,2
1406,10/14/2019,Dominica,Nicaragua,0,4,CONCACAF Nations League B,Dominica,1,-4
1407,10/14/2019,Guadeloupe,Sint Maarten,2,1,CONCACAF Nations League C,Curaçao,0,1
1408,10/14/2019,Suriname,St Vincent & Grenadines,0,1,CONCACAF Nations League B,Suriname,1,-1
1409,10/14/2019,Bulgaria,England,0,6,European Championship qual,Bulgaria,1,-6
1410,10/14/2019,Czechia,Northern Ireland,2,3,Friendly,Czechia,1,-1
1411,10/14/2019,France,Turkey,1,1,European Championship qual,France,1,0
1412,10/14/2019,Ukraine,Portugal,2,1,European Championship qual,Ukraine,1,1
1413,10/14/2019,Lithuania,Serbia,1,2,European Championship qual,Lithuania,1,-1
1414,10/14/2019,Iceland,Andorra,2,0,European Championship qual,Iceland,1,2
1415,10/14/2019,Moldova,Albania,0,4,European Championship qual,Moldova,1,-4
1416,10/14/2019,Kosovo,Montenegro,2,0,European Championship qual,Kosovo,1,2
1417,10/15/2019,Tajikistan,Japan,0,3,World Cup and Asian Cup qual,Tajikistan,1,-3
1418,10/15/2019,Philippines,China,0,0,World Cup and Asian Cup qual,Philippines,1,0
1419,10/15/2019,Taiwan,Australia,1,7,World Cup and Asian Cup qual,Taiwan,1,-6
1420,10/15/2019,Indonesia,Vietnam,1,3,World Cup and Asian Cup qual,Indonesia,1,-2
1421,10/15/2019,India,Bangladesh,1,1,World Cup and Asian Cup qual,India,1,0
1422,10/15/2019,Sri Lanka,Lebanon,0,3,World Cup and Asian Cup qual,Sri Lanka,1,-3
1423,10/15/2019,Bahrain,Iran,1,0,World Cup and Asian Cup qual,Bahrain,1,1
1424,10/15/2019,Mongolia,Kyrgyzstan,1,2,World Cup and Asian Cup qual,Mongolia,1,-1
1425,10/15/2019,North Korea,South Korea,0,0,World Cup and Asian Cup qual,North Korea,1,0
1426,10/15/2019,Syria,Guam,4,0,World Cup and Asian Cup qual,United Arab Emirates,0,4
1427,10/15/2019,Singapore,Uzbekistan,1,3,World Cup and Asian Cup qual,Singapore,1,-2
1428,10/15/2019,Cambodia,Iraq,0,4,World Cup and Asian Cup qual,Cambodia,1,-4
1429,10/15/2019,Thailand,United Arab Emirates,2,1,World Cup and Asian Cup qual,Thailand,1,1
1430,10/15/2019,Kuwait,Turkmenistan,1,1,Friendly,Kuwait,1,0
1431,10/15/2019,Jordan,Nepal,3,0,World Cup and Asian Cup qual,Jordan,1,3
1432,10/15/2019,Palestine,Saudi Arabia,0,0,World Cup and Asian Cup qual,Palestine,1,0
1433,10/15/2019,Qatar,Oman,2,1,World Cup and Asian Cup qual,Qatar,1,1
1434,10/15/2019,Mauritania,Libya,0,0,Friendly,Mauritania,1,0
1435,10/15/2019,Morocco,Gabon,2,3,Friendly,Morocco,1,-1
1436,10/15/2019,Chile,Guinea,3,2,Friendly,Spain,0,1
1437,10/15/2019,Algeria,Colombia,3,0,Friendly,France,0,3
1438,10/15/2019,Canada,United States,2,0,CONCACAF Nations League A,Canada,1,2
1439,10/15/2019,Saint Lucia,El Salvador,0,2,CONCACAF Nations League B,Saint Lucia,1,-2
1440,10/15/2019,Bermuda,Guatemala,0,0,Friendly,Bermuda,1,0
1441,10/15/2019,Mexico,Panama,3,1,CONCACAF Nations League A,Mexico,1,2
1442,10/15/2019,Jamaica,Aruba,6,0,CONCACAF Nations League B,Curaçao,0,6
1443,10/15/2019,Bolivia,Haiti,3,1,Friendly,Bolivia,1,2
1444,10/15/2019,US Virgin Islands,Barbados,0,4,CONCACAF Nations League C,US Virgin Islands,1,-4
1445,10/15/2019,Anguilla,Puerto Rico,2,3,CONCACAF Nations League C,Anguilla,1,-1
1446,10/15/2019,Dominican Republic,Montserrat,0,0,CONCACAF Nations League B,Dominican Republic,1,0
1447,10/15/2019,Cayman Islands,Saint Martin,1,0,CONCACAF Nations League C,Cayman Islands,1,1
1448,10/15/2019,Peru,Uruguay,1,1,Friendly,Peru,1,0
1449,10/15/2019,Switzerland,Ireland,2,0,European Championship qual,Switzerland,1,2
1450,10/15/2019,Sweden,Spain,1,1,European Championship qual,Sweden,1,0
1451,10/15/2019,Romania,Norway,1,1,European Championship qual,Romania,1,0
1452,10/15/2019,Liechtenstein,Italy,0,5,European Championship qual,Liechtenstein,1,-5
1453,10/15/2019,Finland,Armenia,3,0,European Championship qual,Finland,1,3
1454,10/15/2019,Denmark,Luxembourg,4,0,Friendly,Denmark,1,4
1455,10/15/2019,Israel,Latvia,3,1,European Championship qual,Israel,1,2
1456,10/15/2019,Greece,Bosnia and Herzegovina,2,1,European Championship qual,Greece,1,1
1457,10/15/2019,Faroe Islands,Malta,1,0,European Championship qual,Faroe Islands,1,1
1458,10/15/2019,Gibraltar,Georgia,2,3,European Championship qual,Gibraltar,1,-1
1459,11/5/2019,Malaysia,Maldives,2,1,Friendly,Malaysia,1,1
1460,11/7/2019,Myanmar,Nepal,3,0,Friendly,Myanmar,1,3
1461,11/7/2019,Egypt,Liberia,1,0,Friendly,Egypt,1,1
1462,11/7/2019,Nicaragua,Cuba,0,0,Friendly,Nicaragua,1,0
1463,11/9/2019,Malaysia,Tajikistan,1,0,Friendly,Malaysia,1,1
1464,11/9/2019,Uzbekistan,Kyrgyzstan,3,1,Friendly,Uzbekistan,1,2
1465,11/9/2019,Namibia,Zambia,0,2,Friendly,Namibia,1,-2
1466,11/10/2019,Trinidad and Tobago,Anguilla,15,0,Friendly,Trinidad and Tobago,1,15
1467,11/10/2019,Nicaragua,Cuba,0,1,Friendly,Nicaragua,1,-1
1468,11/13/2019,Burkina Faso,Uganda,0,0,African Nations Cup qualifier,Burkina Faso,1,0
1469,11/13/2019,Sierra Leone,Lesotho,1,1,African Nations Cup qualifier,Sierra Leone,1,0
1470,11/13/2019,Nigeria,Benin,2,1,African Nations Cup qualifier,Nigeria,1,1
1471,11/13/2019,Angola,Gambia,1,3,African Nations Cup qualifier,Angola,1,-2
1472,11/13/2019,Guinea-Bissau,Eswatini,3,0,African Nations Cup qualifier,Guinea-Bissau,1,3
1473,11/13/2019,Central African Republic,Burundi,2,0,African Nations Cup qualifier,Central African Republic,1,2
1474,11/13/2019,Sudan,São Tomé and Príncipe,4,0,African Nations Cup qualifier,Sudan,1,4
1475,11/13/2019,Malawi,South Sudan,1,0,African Nations Cup qualifier,Malawi,1,1
1476,11/13/2019,Cameroon,Cape Verde,0,0,African Nations Cup qualifier,Cameroon,1,0
1477,11/13/2019,Senegal,Congo,2,0,African Nations Cup qualifier,Senegal,1,2
1478,11/13/2019,Namibia,Chad,2,1,African Nations Cup qualifier,Namibia,1,1
1479,11/14/2019,Kyrgyzstan,Japan,0,2,World Cup and Asian Cup qual,Kyrgyzstan,1,-2
1480,11/14/2019,Maldives,Philippines,1,2,World Cup and Asian Cup qual,Maldives,1,-1
1481,11/14/2019,Jordan,Australia,0,1,World Cup and Asian Cup qual,Jordan,1,-1
1482,11/14/2019,Syria,China,2,1,World Cup and Asian Cup qual,United Arab Emirates,0,1
1483,11/14/2019,Afghanistan,India,1,1,World Cup and Asian Cup qual,Tajikistan,0,0
1484,11/14/2019,Lebanon,South Korea,0,0,World Cup and Asian Cup qual,Lebanon,1,0
1485,11/14/2019,Iraq,Iran,2,1,World Cup and Asian Cup qual,Jordan,0,1
1486,11/14/2019,Cambodia,Mongolia,1,1,Friendly,Cambodia,1,0
1487,11/14/2019,Vietnam,United Arab Emirates,1,0,World Cup and Asian Cup qual,Vietnam,1,1
1488,11/14/2019,Kuwait,Taiwan,9,0,World Cup and Asian Cup qual,Kuwait,1,9
1489,11/14/2019,Myanmar,Tajikistan,4,3,World Cup and Asian Cup qual,Myanmar,1,1
1490,11/14/2019,Hong Kong,Bahrain,0,0,World Cup and Asian Cup qual,Hong Kong,1,0
1491,11/14/2019,Qatar,Singapore,2,0,Friendly,Qatar,1,2
1492,11/14/2019,Malaysia,Thailand,2,1,World Cup and Asian Cup qual,Malaysia,1,1
1493,11/14/2019,Turkmenistan,North Korea,3,1,World Cup and Asian Cup qual,Turkmenistan,1,2
1494,11/14/2019,Uzbekistan,Saudi Arabia,2,3,World Cup and Asian Cup qual,Uzbekistan,1,-1
1495,11/14/2019,Yemen,Palestine,1,0,World Cup and Asian Cup qual,Bahrain,0,1
1496,11/14/2019,Oman,Bangladesh,4,1,World Cup and Asian Cup qual,Oman,1,3
1497,11/14/2019,Egypt,Kenya,1,1,African Nations Cup qualifier,Egypt,1,0
1498,11/14/2019,Ghana,South Africa,2,0,African Nations Cup qualifier,Ghana,1,2
1499,11/14/2019,Algeria,Zambia,5,0,African Nations Cup qualifier,Algeria,1,5
1500,11/14/2019,DR Congo,Gabon,0,0,African Nations Cup qualifier,DR Congo,1,0
1501,11/14/2019,Togo,Comoros,0,1,African Nations Cup qualifier,Togo,1,-1
1502,11/14/2019,Mali,Guinea,2,2,African Nations Cup qualifier,Mali,1,0
1503,11/14/2019,Mozambique,Rwanda,2,0,African Nations Cup qualifier,Mozambique,1,2
1504,11/14/2019,Curaçao,Costa Rica,1,2,CONCACAF Nations League A,Curaçao,1,-1
1505,11/14/2019,Martinique,Honduras,1,1,CONCACAF Nations League A,Martinique,1,0
1506,11/14/2019,Ecuador,Trinidad and Tobago,3,0,Friendly,Ecuador,1,3
1507,11/14/2019,Belize,French Guiana,2,0,CONCACAF Nations League B,Belize,1,2
1508,11/14/2019,Saint Kitts and Nevis,Grenada,0,0,CONCACAF Nations League B,Saint Kitts and Nevis,1,0
1509,11/14/2019,Bahamas,British Virgin Islands,3,0,CONCACAF Nations League C,Bahamas,1,3
1510,11/14/2019,Turks and Caicos Islands,Sint Maarten,3,2,CONCACAF Nations League C,Turks and Caicos Islands,1,1
1511,11/14/2019,Bulgaria,Paraguay,0,1,Friendly,Bulgaria,1,-1
1512,11/14/2019,Ireland,New Zealand,3,1,Friendly,Ireland,1,2
1513,11/14/2019,England,Montenegro,7,0,European Championship qual,England,1,7
1514,11/14/2019,France,Moldova,2,1,European Championship qual,France,1,1
1515,11/14/2019,Serbia,Luxembourg,3,2,European Championship qual,Serbia,1,1
1516,11/14/2019,Ukraine,Estonia,1,0,Friendly,Ukraine,1,1
1517,11/14/2019,Portugal,Lithuania,6,0,European Championship qual,Portugal,1,6
1518,11/14/2019,Turkey,Iceland,0,0,European Championship qual,Turkey,1,0
1519,11/14/2019,Albania,Andorra,2,2,European Championship qual,Albania,1,0
1520,11/14/2019,Czechia,Kosovo,2,1,European Championship qual,Czechia,1,1
1521,11/15/2019,Tanzania,Equatorial Guinea,2,1,African Nations Cup qualifier,Tanzania,1,1
1522,11/15/2019,Zimbabwe,Botswana,0,0,African Nations Cup qualifier,Zimbabwe,1,0
1523,11/15/2019,Tunisia,Libya,4,1,African Nations Cup qualifier,Tunisia,1,3
1524,11/15/2019,Morocco,Mauritania,0,0,African Nations Cup qualifier,Morocco,1,0
1525,11/15/2019,United States,Canada,4,1,CONCACAF Nations League A,United States,1,3
1526,11/15/2019,Panama,Mexico,0,3,CONCACAF Nations League A,Panama,1,-3
1527,11/15/2019,Guyana,Aruba,4,2,CONCACAF Nations League B,Guyana,1,2
1528,11/15/2019,Antigua and Barbuda,Jamaica,0,2,CONCACAF Nations League B,Antigua and Barbuda,1,-2
1529,11/15/2019,St Vincent & Grenadines,Nicaragua,1,0,CONCACAF Nations League B,St Vincent & Grenadines,1,1
1530,11/15/2019,Suriname,Dominica,4,0,CONCACAF Nations League B,Suriname,1,4
1531,11/15/2019,Hungary,Uruguay,1,2,Friendly,Hungary,1,-1
1532,11/15/2019,Argentina,Brazil,1,0,Friendly,Saudi Arabia,0,1
1533,11/15/2019,Colombia,Peru,1,0,Friendly,United States,0,1
1534,11/15/2019,Switzerland,Georgia,1,0,European Championship qual,Switzerland,1,1
1535,11/15/2019,Romania,Sweden,0,2,European Championship qual,Romania,1,-2
1536,11/15/2019,Norway,Faroe Islands,4,0,European Championship qual,Norway,1,4
1537,11/15/2019,Bosnia and Herzegovina,Italy,0,3,European Championship qual,Bosnia and Herzegovina,1,-3
1538,11/15/2019,Finland,Liechtenstein,3,0,European Championship qual,Finland,1,3
1539,11/15/2019,Denmark,Gibraltar,6,0,European Championship qual,Denmark,1,6
1540,11/15/2019,Spain,Malta,7,0,European Championship qual,Spain,1,7
1541,11/15/2019,Armenia,Greece,0,1,European Championship qual,Armenia,1,-1
1542,11/16/2019,Madagascar,Ethiopia,1,0,African Nations Cup qualifier,Madagascar,1,1
1543,11/16/2019,Ivory Coast,Niger,1,0,African Nations Cup qualifier,Ivory Coast,1,1
1544,11/16/2019,El Salvador,Montserrat,1,0,CONCACAF Nations League B,El Salvador,1,1
1545,11/16/2019,Guatemala,Puerto Rico,5,0,CONCACAF Nations League C,Guatemala,1,5
1546,11/16/2019,Saint Martin,Barbados,1,0,CONCACAF Nations League C,Anguilla,0,1
1547,11/16/2019,Saint Lucia,Dominican Republic,1,0,CONCACAF Nations League B,Saint Lucia,1,1
1548,11/16/2019,Cayman Islands,US Virgin Islands,1,0,CONCACAF Nations League C,Cayman Islands,1,1
1549,11/16/2019,Cyprus,Scotland,1,2,European Championship qual,Cyprus,1,-1
1550,11/16/2019,Azerbaijan,Wales,0,2,European Championship qual,Azerbaijan,1,-2
1551,11/16/2019,Northern Ireland,Netherlands,0,0,European Championship qual,Northern Ireland,1,0
1552,11/16/2019,Austria,North Macedonia,2,1,European Championship qual,Austria,1,1
1553,11/16/2019,Russia,Belgium,1,4,European Championship qual,Russia,1,-3
1554,11/16/2019,Germany,Belarus,4,0,European Championship qual,Germany,1,4
1555,11/16/2019,Israel,Poland,1,2,European Championship qual,Israel,1,-1
1556,11/16/2019,Slovenia,Latvia,1,0,European Championship qual,Slovenia,1,1
1557,11/16/2019,Croatia,Slovakia,3,1,European Championship qual,Croatia,1,2
1558,11/16/2019,San Marino,Kazakhstan,1,3,European Championship qual,San Marino,1,-2
1559,11/17/2019,South Africa,Sudan,1,0,African Nations Cup qualifier,South Africa,1,1
1560,11/17/2019,Uganda,Malawi,2,0,African Nations Cup qualifier,Uganda,1,2
1561,11/17/2019,Benin,Sierra Leone,1,0,African Nations Cup qualifier,Benin,1,1
1562,11/17/2019,Lesotho,Nigeria,2,4,African Nations Cup qualifier,Lesotho,1,-2
1563,11/17/2019,Congo,Guinea-Bissau,3,0,African Nations Cup qualifier,Congo,1,3
1564,11/17/2019,Rwanda,Cameroon,0,1,African Nations Cup qualifier,Rwanda,1,-1
1565,11/17/2019,Chad,Mali,0,2,African Nations Cup qualifier,Chad,1,-2
1566,11/17/2019,Gabon,Angola,2,1,African Nations Cup qualifier,Gabon,1,1
1567,11/17/2019,Burkina Faso,South Sudan,2,1,African Nations Cup qualifier,Sudan,0,1
1568,11/17/2019,Eswatini,Senegal,1,4,African Nations Cup qualifier,Eswatini,1,-3
1569,11/17/2019,Guinea,Namibia,2,0,African Nations Cup qualifier,Guinea,1,2
1570,11/17/2019,Costa Rica,Haiti,1,1,CONCACAF Nations League A,Costa Rica,1,0
1571,11/17/2019,Honduras,Trinidad and Tobago,4,0,CONCACAF Nations League A,Honduras,1,4
1572,11/17/2019,Guadeloupe,Turks and Caicos Islands,10,0,CONCACAF Nations League C,Guadeloupe,1,10
1573,11/17/2019,French Guiana,Saint Kitts and Nevis,3,1,CONCACAF Nations League B,French Guiana,1,2
1574,11/17/2019,Grenada,Belize,3,2,CONCACAF Nations League B,Grenada,1,1
1575,11/17/2019,Bahamas,Bonaire,1,1,CONCACAF Nations League C,Curaçao,0,0
1576,11/17/2019,Lithuania,New Zealand,1,0,Friendly,Lithuania,1,1
1577,11/17/2019,Kosovo,England,0,4,European Championship qual,Kosovo,1,-4
1578,11/17/2019,Albania,France,0,2,European Championship qual,Albania,1,-2
1579,11/17/2019,Luxembourg,Portugal,0,2,European Championship qual,Luxembourg,1,-2
1580,11/17/2019,Andorra,Turkey,0,2,European Championship qual,Andorra,1,-2
1581,11/17/2019,Bulgaria,Czechia,1,0,European Championship qual,Bulgaria,1,1
1582,11/17/2019,Serbia,Ukraine,2,2,European Championship qual,Serbia,1,0
1583,11/17/2019,Moldova,Iceland,1,2,European Championship qual,Moldova,1,-1
1584,11/18/2019,Comoros,Egypt,0,0,African Nations Cup qualifier,Comoros,1,0
1585,11/18/2019,Kenya,Togo,1,1,African Nations Cup qualifier,Kenya,1,0
1586,11/18/2019,Gambia,DR Congo,2,2,African Nations Cup qualifier,The Gambia,0,0
1587,11/18/2019,São Tomé and Príncipe,Ghana,0,1,African Nations Cup qualifier,São Tomé and Príncipe,1,-1
1588,11/18/2019,Cape Verde,Mozambique,2,2,African Nations Cup qualifier,Cape Verde,1,0
1589,11/18/2019,Botswana,Algeria,0,1,African Nations Cup qualifier,Botswana,1,-1
1590,11/18/2019,Antigua and Barbuda,Aruba,3,2,CONCACAF Nations League B,Curaçao,0,1
1591,11/18/2019,Jamaica,Guyana,1,1,CONCACAF Nations League B,Jamaica,1,0
1592,11/18/2019,Nicaragua,Suriname,1,2,CONCACAF Nations League B,Nicaragua,1,-1
1593,11/18/2019,Dominica,St Vincent & Grenadines,1,0,CONCACAF Nations League B,Dominica,1,1
1594,11/18/2019,Argentina,Uruguay,2,2,Friendly,Israel,0,0
1595,11/18/2019,Gibraltar,Switzerland,1,6,European Championship qual,Gibraltar,1,-5
1596,11/18/2019,Sweden,Faroe Islands,3,0,European Championship qual,Sweden,1,3
1597,11/18/2019,Malta,Norway,1,2,European Championship qual,Malta,1,-1
1598,11/18/2019,Italy,Armenia,9,1,European Championship qual,Italy,1,8
1599,11/18/2019,Greece,Finland,2,1,European Championship qual,Greece,1,1
1600,11/18/2019,Ireland,Denmark,1,1,European Championship qual,Ireland,1,0
1601,11/18/2019,Spain,Romania,5,0,European Championship qual,Spain,1,5
1602,11/18/2019,Liechtenstein,Bosnia and Herzegovina,0,3,European Championship qual,Liechtenstein,1,-3
1603,11/19/2019,Japan,Venezuela,1,4,Friendly,Japan,1,-3
1604,11/19/2019,Syria,Philippines,1,0,World Cup and Asian Cup qual,United Arab Emirates,0,1
1605,11/19/2019,Malaysia,Indonesia,2,0,World Cup and Asian Cup qual,Malaysia,1,2
1606,11/19/2019,Oman,India,1,0,World Cup and Asian Cup qual,Oman,1,1
1607,11/19/2019,Lebanon,North Korea,0,0,World Cup and Asian Cup qual,Lebanon,1,0
1608,11/19/2019,Qatar,Afghanistan,1,0,World Cup and Asian Cup qual,Tajikistan,0,1
1609,11/19/2019,Myanmar,Mongolia,1,0,World Cup and Asian Cup qual,Myanmar,1,1
1610,11/19/2019,Brazil,South Korea,3,0,Friendly,United Arab Emirates,0,3
1611,11/19/2019,Vietnam,Thailand,0,0,World Cup and Asian Cup qual,Vietnam,1,0
1612,11/19/2019,Jordan,Taiwan,5,0,World Cup and Asian Cup qual,Jordan,1,5
1613,11/19/2019,Turkmenistan,Sri Lanka,2,0,World Cup and Asian Cup qual,Turkmenistan,1,2
1614,11/19/2019,Hong Kong,Cambodia,2,0,World Cup and Asian Cup qual,Hong Kong,1,2
1615,11/19/2019,Singapore,Yemen,2,1,World Cup and Asian Cup qual,Bahrain,0,1
1616,11/19/2019,Kyrgyzstan,Tajikistan,1,1,World Cup and Asian Cup qual,Kyrgyzstan,1,0
1617,11/19/2019,Bahrain,Iraq,0,0,World Cup and Asian Cup qual,Jordan,0,0
1618,11/19/2019,Kuwait,Nepal,1,0,World Cup and Asian Cup qual,Bhutan,0,1
1619,11/19/2019,Saudi Arabia,Paraguay,0,0,Friendly,Saudi Arabia,1,0
1620,11/19/2019,Uzbekistan,Palestine,2,0,World Cup and Asian Cup qual,Uzbekistan,1,2
1621,11/19/2019,Maldives,Guam,3,1,World Cup and Asian Cup qual,Maldives,1,2
1622,11/19/2019,Libya,Tanzania,2,1,African Nations Cup qualifier,Tunisia,0,1
1623,11/19/2019,Zambia,Zimbabwe,1,2,African Nations Cup qualifier,Zambia,1,-1
1624,11/19/2019,Niger,Madagascar,2,6,African Nations Cup qualifier,Niger,1,-4
1625,11/19/2019,Ethiopia,Ivory Coast,2,1,African Nations Cup qualifier,Ethiopia,1,1
1626,11/19/2019,Burundi,Morocco,0,3,African Nations Cup qualifier,Burundi,1,-3
1627,11/19/2019,Equatorial Guinea,Tunisia,0,1,African Nations Cup qualifier,Equatorial Guinea,1,-1
1628,11/19/2019,Mauritania,Central African Republic,2,0,African Nations Cup qualifier,Mauritania,1,2
1629,11/19/2019,United States,Cuba,4,0,CONCACAF Nations League A,Cayman Islands,0,4
1630,11/19/2019,El Salvador,Dominican Republic,2,0,CONCACAF Nations League B,El Salvador,1,2
1631,11/19/2019,Mexico,Bermuda,2,1,CONCACAF Nations League A,Mexico,1,1
1632,11/19/2019,Barbados,Cayman Islands,3,0,CONCACAF Nations League C,Barbados,1,3
1633,11/19/2019,Saint Lucia,Montserrat,0,1,CONCACAF Nations League B,Saint Lucia,1,-1
1634,11/19/2019,Puerto Rico,Anguilla,3,0,CONCACAF Nations League C,Puerto Rico,1,3
1635,11/19/2019,US Virgin Islands,Saint Martin,1,2,CONCACAF Nations League C,US Virgin Islands,1,-1
1636,11/19/2019,Colombia,Ecuador,1,0,Friendly,United States,0,1
1637,11/19/2019,Scotland,Kazakhstan,3,1,European Championship qual,Scotland,1,2
1638,11/19/2019,Wales,Hungary,2,0,European Championship qual,Wales,1,2
1639,11/19/2019,Germany,Northern Ireland,6,1,European Championship qual,Germany,1,5
1640,11/19/2019,Latvia,Austria,1,0,European Championship qual,Latvia,1,1
1641,11/19/2019,Belgium,Cyprus,6,1,European Championship qual,Belgium,1,5
1642,11/19/2019,Netherlands,Estonia,5,0,European Championship qual,Netherlands,1,5
1643,11/19/2019,San Marino,Russia,0,5,European Championship qual,San Marino,1,-5
1644,11/19/2019,Poland,Slovenia,3,2,European Championship qual,Poland,1,1
1645,11/19/2019,Montenegro,Belarus,2,0,Friendly,Montenegro,1,2
1646,11/19/2019,North Macedonia,Israel,1,0,European Championship qual,North Macedonia,1,1
1647,11/19/2019,Slovakia,Azerbaijan,2,0,European Championship qual,Slovakia,1,2
1648,11/19/2019,Croatia,Georgia,2,1,Friendly,Croatia,1,1
1649,11/21/2019,Guatemala,Antigua and Barbuda,8,0,Friendly,Guatemala,1,8
1650,11/26/2019,Qatar,Iraq,1,2,Gulf Cup,Qatar,1,-1
1651,11/26/2019,United Arab Emirates,Yemen,3,0,Gulf Cup,Qatar,0,3
1652,11/27/2019,Kuwait,Saudi Arabia,3,1,Gulf Cup,Qatar,0,2
1653,11/27/2019,Bahrain,Oman,0,0,Gulf Cup,Qatar,0,0
1654,11/29/2019,Iraq,United Arab Emirates,2,0,Gulf Cup,Qatar,0,2
1655,11/29/2019,Qatar,Yemen,6,0,Gulf Cup,Qatar,1,6
1656,11/30/2019,Oman,Kuwait,2,1,Gulf Cup,Qatar,0,1
1657,11/30/2019,Saudi Arabia,Bahrain,2,0,Gulf Cup,Qatar,0,2
1658,12/2/2019,Iraq,Yemen,0,0,Gulf Cup,Qatar,0,0
1659,12/2/2019,Bahrain,Kuwait,4,2,Gulf Cup,Qatar,0,2
1660,12/2/2019,Saudi Arabia,Oman,3,1,Gulf Cup,Qatar,0,2
1661,12/2/2019,Qatar,United Arab Emirates,4,2,Gulf Cup,Qatar,1,2
1662,12/5/2019,Bahrain,Iraq,2,2,Gulf Cup,Qatar,0,0
1663,12/5/2019,Qatar,Saudi Arabia,0,1,Gulf Cup,Qatar,1,-1
1664,12/7/2019,Uganda,Burundi,2,1,CECAFA Cup,Uganda,1,1
1665,12/7/2019,Djibouti,Somalia,0,0,CECAFA Cup,Uganda,0,0
1666,12/8/2019,Bahrain,Saudi Arabia,1,0,Gulf Cup,Qatar,0,1
1667,12/8/2019,Kenya,Tanzania,1,0,CECAFA Cup,Uganda,0,1
1668,12/8/2019,Sudan,Zanzibar,1,1,CECAFA Cup,Uganda,0,0
1669,12/9/2019,Uganda,Somalia,2,0,CECAFA Cup,Uganda,1,2
1670,12/9/2019,Eritrea,Burundi,1,0,CECAFA Cup,Uganda,0,1
1671,12/10/2019,Japan,China,2,1,East Asian Championship,South Korea,0,1
1672,12/10/2019,Kenya,Sudan,2,1,CECAFA Cup,Uganda,0,1
1673,12/10/2019,Tanzania,Zanzibar,1,0,CECAFA Cup,Uganda,0,1
1674,12/11/2019,South Korea,Hong Kong,2,0,East Asian Championship,South Korea,1,2
1675,12/11/2019,Uganda,Eritrea,2,0,CECAFA Cup,Uganda,1,2
1676,12/11/2019,Djibouti,Burundi,2,1,CECAFA Cup,Uganda,0,1
1677,12/13/2019,Eritrea,Djibouti,3,0,CECAFA Cup,Uganda,0,3
1678,12/13/2019,Somalia,Burundi,1,0,CECAFA Cup,Uganda,0,1
1679,12/14/2019,Japan,Hong Kong,5,0,East Asian Championship,South Korea,0,5
1680,12/14/2019,Kenya,Zanzibar,1,0,CECAFA Cup,Uganda,0,1
1681,12/14/2019,Sudan,Tanzania,0,0,CECAFA Cup,Uganda,0,0
1682,12/15/2019,South Korea,China,1,0,East Asian Championship,South Korea,1,1
1683,12/15/2019,Uganda,Djibouti,4,1,CECAFA Cup,Uganda,1,3
1684,12/15/2019,Eritrea,Somalia,0,0,CECAFA Cup,Uganda,0,0
1685,12/17/2019,Eritrea,Kenya,4,1,CECAFA Cup,Uganda,0,3
1686,12/17/2019,Uganda,Tanzania,1,0,CECAFA Cup,Uganda,1,1
1687,12/18/2019,South Korea,Japan,1,0,East Asian Championship,South Korea,1,1
1688,12/18/2019,China,Hong Kong,2,0,East Asian Championship,South Korea,0,2
1689,12/19/2019,Kenya,Tanzania,2,1,CECAFA Cup,Uganda,0,1
1690,12/19/2019,Uganda,Eritrea,3,0,CECAFA Cup,Uganda,1,3
1691,1/7/2020,Canada,Barbados,4,1,Friendly,United States,0,3
1692,1/9/2020,Sweden,Moldova,1,0,Friendly,Qatar,0,1
1693,1/10/2020,Canada,Barbados,4,1,Friendly,United States,0,3
1694,1/12/2020,Sweden,Kosovo,1,0,Friendly,Qatar,0,1
1695,1/15/2020,Bangladesh,Palestine,0,2,Bangabandhu Gold Cup,Bangladesh,1,-2
1696,1/15/2020,Iceland,Canada,1,0,Friendly,United States,0,1
1697,1/16/2020,Burundi,Mauritius,4,1,Bangabandhu Gold Cup,Bangladesh,0,3
1698,1/17/2020,Palestine,Sri Lanka,2,0,Bangabandhu Gold Cup,Bangladesh,0,2
1699,1/18/2020,Burundi,Seychelles,3,1,Bangabandhu Gold Cup,Bangladesh,0,2
1700,1/19/2020,Bangladesh,Sri Lanka,3,0,Bangabandhu Gold Cup,Bangladesh,1,3
1701,1/19/2020,Iceland,El Salvador,1,0,Friendly,United States,0,1
1702,1/20/2020,Mauritius,Seychelles,2,2,Bangabandhu Gold Cup,Bangladesh,0,0
1703,1/22/2020,Palestine,Seychelles,1,0,Bangabandhu Gold Cup,Bangladesh,0,1
1704,1/23/2020,Bangladesh,Burundi,0,3,Bangabandhu Gold Cup,Bangladesh,1,-3
1705,1/25/2020,Palestine,Burundi,3,1,Bangabandhu Gold Cup,Bangladesh,0,2
1706,1/25/2020,Eritrea,Sudan,0,1,Friendly,Eritrea,1,-1
1707,2/1/2020,United States,Costa Rica,1,0,Friendly,United States,1,1
1708,2/23/2020,Belarus,Uzbekistan,1,0,Friendly,United Arab Emirates,0,1
1709,2/25/2020,Nicaragua,Panama,0,0,Friendly,Nicaragua,1,0
1710,2/26/2020,Bulgaria,Belarus,0,1,Friendly,Bulgaria,1,-1
1711,3/4/2020,Guatemala,Panama,0,2,Friendly,Guatemala,1,-2
1712,3/11/2020,Jamaica,Bermuda,2,0,Friendly,Jamaica,1,2
1713,9/3/2020,Uzbekistan,Tajikistan,2,1,Friendly,Uzbekistan,1,1
1714,9/3/2020,Finland,Wales,0,1,European Nations League B,Finland,1,-1
1715,9/3/2020,Turkey,Hungary,0,1,European Nations League B,Turkey,1,-1
1716,9/3/2020,Ukraine,Switzerland,2,1,European Nations League A,Ukraine,1,1
1717,9/3/2020,Germany,Spain,1,1,European Nations League A,Germany,1,0
1718,9/3/2020,Russia,Serbia,3,1,European Nations League B,Russia,1,2
1719,9/3/2020,Latvia,Andorra,0,0,European Nations League D,Latvia,1,0
1720,9/3/2020,Bulgaria,Ireland,1,1,European Nations League B,Bulgaria,1,0
1721,9/3/2020,Slovenia,Greece,0,0,European Nations League C,Slovenia,1,0
1722,9/3/2020,Kosovo,Moldova,1,1,European Nations League C,Italy,0,0
1723,9/3/2020,Faroe Islands,Malta,3,2,European Nations League D,Faroe Islands,1,1
1724,9/4/2020,Scotland,Israel,1,1,European Nations League B,Scotland,1,0
1725,9/4/2020,Romania,Northern Ireland,1,1,European Nations League B,Romania,1,0
1726,9/4/2020,Norway,Austria,1,2,European Nations League B,Norway,1,-1
1727,9/4/2020,Netherlands,Poland,1,0,European Nations League A,Netherlands,1,1
1728,9/4/2020,Italy,Bosnia and Herzegovina,1,1,European Nations League A,Italy,1,0
1729,9/4/2020,Lithuania,Kazakhstan,0,2,European Nations League C,Lithuania,1,-2
1730,9/4/2020,Belarus,Albania,0,2,European Nations League C,Belarus,1,-2
1731,9/4/2020,Slovakia,Czechia,1,3,European Nations League B,Slovakia,1,-2
1732,9/5/2020,Iceland,England,0,1,European Nations League A,Iceland,1,-1
1733,9/5/2020,Denmark,Belgium,0,2,European Nations League A,Denmark,1,-2
1734,9/5/2020,Sweden,France,0,1,European Nations League A,Sweden,1,-1
1735,9/5/2020,Azerbaijan,Luxembourg,1,2,European Nations League C,Azerbaijan,1,-1
1736,9/5/2020,Estonia,Georgia,0,1,European Nations League C,Estonia,1,-1
1737,9/5/2020,Portugal,Croatia,4,1,European Nations League A,Portugal,1,3
1738,9/5/2020,Cyprus,Montenegro,0,2,European Nations League C,Cyprus,1,-2
1739,9/5/2020,North Macedonia,Armenia,2,1,European Nations League C,North Macedonia,1,1
1740,9/5/2020,Gibraltar,San Marino,1,0,European Nations League D,Gibraltar,1,1
1741,9/6/2020,Wales,Bulgaria,1,0,European Nations League B,Wales,1,1
1742,9/6/2020,Hungary,Russia,2,3,European Nations League B,Hungary,1,-1
1743,9/6/2020,Switzerland,Germany,1,1,European Nations League A,Switzerland,1,0
1744,9/6/2020,Ireland,Finland,0,1,European Nations League B,Ireland,1,-1
1745,9/6/2020,Spain,Ukraine,4,0,European Nations League A,Spain,1,4
1746,9/6/2020,Malta,Latvia,1,1,European Nations League D,Malta,1,0
1747,9/6/2020,Serbia,Turkey,0,0,European Nations League B,Serbia,1,0
1748,9/6/2020,Kosovo,Greece,1,2,European Nations League C,Kosovo,1,-1
1749,9/6/2020,Slovenia,Moldova,1,0,European Nations League C,Slovenia,1,1
1750,9/6/2020,Andorra,Faroe Islands,0,1,European Nations League D,Andorra,1,-1
1751,9/7/2020,Czechia,Scotland,1,2,European Nations League B,Czechia,1,-1
1752,9/7/2020,Northern Ireland,Norway,1,5,European Nations League B,Northern Ireland,1,-4
1753,9/7/2020,Austria,Romania,2,3,European Nations League B,Austria,1,-1
1754,9/7/2020,Netherlands,Italy,0,1,European Nations League A,Netherlands,1,-1
1755,9/7/2020,Bosnia and Herzegovina,Poland,1,2,European Nations League A,Bosnia and Herzegovina,1,-1
1756,9/7/2020,Albania,Lithuania,0,1,European Nations League C,Albania,1,-1
1757,9/7/2020,Kazakhstan,Belarus,1,2,European Nations League C,Kazakhstan,1,-1
1758,9/7/2020,Israel,Slovakia,1,1,European Nations League B,Israel,1,0
1759,9/8/2020,Denmark,England,0,0,European Nations League A,Denmark,1,0
1760,9/8/2020,Belgium,Iceland,5,1,European Nations League A,Belgium,1,4
1761,9/8/2020,France,Croatia,4,2,European Nations League A,France,1,2
1762,9/8/2020,Sweden,Portugal,0,2,European Nations League A,Sweden,1,-2
1763,9/8/2020,Luxembourg,Montenegro,0,1,European Nations League C,Luxembourg,1,-1
1764,9/8/2020,Armenia,Estonia,2,0,European Nations League C,Armenia,1,2
1765,9/8/2020,Cyprus,Azerbaijan,0,1,European Nations League C,Cyprus,1,-1
1766,9/8/2020,Georgia,North Macedonia,1,1,European Nations League C,Georgia,1,0
1767,9/8/2020,Liechtenstein,San Marino,2,0,European Nations League D,Italy,0,2
1768,9/23/2020,Chad,Sudan,2,3,Friendly,Chad,1,-1
1769,9/25/2020,Chad,Sudan,0,2,Friendly,Chad,1,-2
1770,9/30/2020,Mexico,Guatemala,3,0,Friendly,Mexico,1,3
1771,10/6/2020,Nicaragua,Guatemala,0,0,Friendly,Nicaragua,1,0
1772,10/7/2020,Zambia,Malawi,1,0,Friendly,Zambia,1,1
1773,10/7/2020,Andorra,Cape Verde,1,2,Friendly,Andorra,1,-1
1774,10/7/2020,Netherlands,Mexico,0,1,Friendly,Netherlands,1,-1
1775,10/7/2020,Austria,Greece,2,1,Friendly,Austria,1,1
1776,10/7/2020,France,Ukraine,7,1,Friendly,France,1,6
1777,10/7/2020,Switzerland,Croatia,1,2,Friendly,Switzerland,1,-1
1778,10/7/2020,Germany,Turkey,3,3,Friendly,Germany,1,0
1779,10/7/2020,Italy,Moldova,6,0,Friendly,Italy,1,6
1780,10/7/2020,Poland,Finland,5,1,Friendly,Poland,1,4
1781,10/7/2020,Luxembourg,Liechtenstein,1,2,Friendly,Luxembourg,1,-1
1782,10/7/2020,Denmark,Faroe Islands,4,0,Friendly,Denmark,1,4
1783,10/7/2020,Estonia,Lithuania,1,3,Friendly,Estonia,1,-2
1784,10/7/2020,Portugal,Spain,0,0,Friendly,Portugal,1,0
1785,10/7/2020,Montenegro,Latvia,1,1,Friendly,Montenegro,1,0
1786,10/7/2020,Cyprus,Czechia,1,2,Friendly,Cyprus,1,-1
1787,10/7/2020,Malta,Gibraltar,2,0,Friendly,Malta,1,2
1788,10/7/2020,Slovenia,San Marino,4,0,Friendly,Slovenia,1,4
1789,10/8/2020,Uzbekistan,Iran,1,2,Friendly,Uzbekistan,1,-1
1790,10/8/2020,South Africa,Namibia,1,1,Friendly,South Africa,1,0
1791,10/8/2020,Guinea-Bissau,Mozambique,1,0,Friendly,Portugal,0,1
1792,10/8/2020,Belgium,Ivory Coast,1,1,Friendly,Belgium,1,0
1793,10/8/2020,Uruguay,Chile,2,1,World Cup qualifier,Uruguay,1,1
1794,10/8/2020,Argentina,Ecuador,1,0,World Cup qualifier,Argentina,1,1
1795,10/8/2020,Paraguay,Peru,2,2,World Cup qualifier,Paraguay,1,0
1796,10/8/2020,Scotland,Israel,0,0,European Championship qual,Scotland,1,0
1797,10/8/2020,England,Wales,3,0,Friendly,England,1,3
1798,10/8/2020,Bosnia and Herzegovina,Northern Ireland,1,1,European Championship qual,Bosnia and Herzegovina,1,0
1799,10/8/2020,Bulgaria,Hungary,1,3,European Championship qual,Bulgaria,1,-2
1800,10/8/2020,Russia,Sweden,1,2,Friendly,Russia,1,-1
1801,10/8/2020,Norway,Serbia,1,2,European Championship qual,Norway,1,-1
1802,10/8/2020,Iceland,Romania,2,1,European Championship qual,Iceland,1,1
1803,10/8/2020,Slovakia,Ireland,0,0,European Championship qual,Slovakia,1,0
1804,10/8/2020,Georgia,Belarus,1,0,European Championship qual,Georgia,1,1
1805,10/8/2020,North Macedonia,Kosovo,2,1,European Championship qual,North Macedonia,1,1
1806,10/9/2020,Cameroon,Japan,0,0,Friendly,Netherlands,0,0
1807,10/9/2020,Kenya,Zambia,2,1,Friendly,Kenya,1,1
1808,10/9/2020,Burkina Faso,DR Congo,3,0,Friendly,Morocco,0,3
1809,10/9/2020,Mauritania,Sierra Leone,2,1,Friendly,Mauritania,1,1
1810,10/9/2020,Algeria,Nigeria,1,0,Friendly,Austria,0,1
1811,10/9/2020,Mali,Ghana,3,0,Friendly,Turkey,0,3
1812,10/9/2020,Gambia,Congo,1,0,Friendly,Portugal,0,1
1813,10/9/2020,Tunisia,Sudan,3,0,Friendly,Tunisia,1,3
1814,10/9/2020,Morocco,Senegal,3,1,Friendly,Morocco,1,2
1815,10/9/2020,Brazil,Bolivia,5,0,World Cup qualifier,Brazil,1,5
1816,10/9/2020,Colombia,Venezuela,3,0,World Cup qualifier,Colombia,1,3
1817,10/10/2020,Guinea,Cape Verde,2,1,Friendly,Portugal,0,1
1818,10/10/2020,Niger,Chad,2,0,Friendly,Niger,1,2
1819,10/10/2020,Costa Rica,Panama,0,1,Friendly,Costa Rica,1,-1
1820,10/10/2020,Honduras,Nicaragua,1,1,Friendly,Honduras,1,0
1821,10/10/2020,Spain,Switzerland,1,0,European Nations League A,Spain,1,1
1822,10/10/2020,Ukraine,Germany,1,2,European Nations League A,Ukraine,1,-1
1823,10/10/2020,Luxembourg,Cyprus,2,0,European Nations League C,Luxembourg,1,2
1824,10/10/2020,Faroe Islands,Latvia,1,1,European Nations League D,Faroe Islands,1,0
1825,10/10/2020,Montenegro,Azerbaijan,2,0,European Nations League C,Montenegro,1,2
1826,10/10/2020,Andorra,Malta,0,0,European Nations League D,Andorra,1,0
1827,10/10/2020,Liechtenstein,Gibraltar,0,1,European Nations League D,Liechtenstein,1,-1
1828,10/11/2020,South Africa,Zambia,1,2,Friendly,South Africa,1,-1
1829,10/11/2020,Tanzania,Burundi,0,1,Friendly,Tanzania,1,-1
1830,10/11/2020,Malawi,Zimbabwe,0,0,Friendly,Malawi,1,0
1831,10/11/2020,Comoros,Libya,2,1,Friendly,Tunisia,0,1
1832,10/11/2020,Benin,Gabon,2,0,Friendly,Portugal,0,2
1833,10/11/2020,Scotland,Slovakia,1,0,European Nations League B,Scotland,1,1
1834,10/11/2020,England,Belgium,2,1,European Nations League A,England,1,1
1835,10/11/2020,Ireland,Wales,0,0,European Nations League B,Ireland,1,0
1836,10/11/2020,Northern Ireland,Austria,0,1,European Nations League B,Northern Ireland,1,-1
1837,10/11/2020,Serbia,Hungary,0,1,European Nations League B,Serbia,1,-1
1838,10/11/2020,France,Portugal,0,0,European Nations League A,France,1,0
1839,10/11/2020,Bosnia and Herzegovina,Netherlands,0,0,European Nations League A,Bosnia and Herzegovina,1,0
1840,10/11/2020,Croatia,Sweden,2,1,European Nations League A,Croatia,1,1
1841,10/11/2020,Norway,Romania,4,0,European Nations League B,Norway,1,4
1842,10/11/2020,Poland,Italy,0,0,European Nations League A,Poland,1,0
1843,10/11/2020,Finland,Bulgaria,2,0,European Nations League B,Finland,1,2
1844,10/11/2020,Russia,Turkey,1,1,European Nations League B,Russia,1,0
1845,10/11/2020,Iceland,Denmark,0,3,European Nations League A,Iceland,1,-3
1846,10/11/2020,Estonia,North Macedonia,3,3,European Nations League C,Estonia,1,0
1847,10/11/2020,Lithuania,Belarus,2,2,European Nations League C,Lithuania,1,0
1848,10/11/2020,Greece,Moldova,2,0,European Nations League C,Greece,1,2
1849,10/11/2020,Israel,Czechia,1,2,European Nations League B,Israel,1,-1
1850,10/11/2020,Kazakhstan,Albania,0,0,European Nations League C,Kazakhstan,1,0
1851,10/11/2020,Armenia,Georgia,2,2,European Nations League C,Poland,0,0
1852,10/11/2020,Kosovo,Slovenia,0,1,European Nations League C,Kosovo,1,-1
1853,10/12/2020,Ghana,Qatar,5,1,Friendly,Turkey,0,4
1854,10/12/2020,United Arab Emirates,Uzbekistan,1,2,Friendly,United Arab Emirates,1,-1
1855,10/12/2020,Burkina Faso,Madagascar,2,1,Friendly,Morocco,0,1
1856,10/12/2020,Sudan,Togo,1,1,Friendly,Tunisia,0,0
1857,10/13/2020,Japan,Ivory Coast,1,0,Friendly,Netherlands,0,1
1858,10/13/2020,Morocco,DR Congo,1,1,Friendly,Morocco,1,0
1859,10/13/2020,Niger,Sierra Leone,1,0,Friendly,Niger,1,1
1860,10/13/2020,Nigeria,Tunisia,1,1,Friendly,Austria,0,0
1861,10/13/2020,Algeria,Mexico,2,2,Friendly,Netherlands,0,0
1862,10/13/2020,Angola,Mozambique,3,0,Friendly,Portugal,0,3
1863,10/13/2020,Costa Rica,Panama,0,1,Friendly,Costa Rica,1,-1
1864,10/13/2020,Ecuador,Uruguay,4,2,World Cup qualifier,Ecuador,1,2
1865,10/13/2020,Bolivia,Argentina,1,2,World Cup qualifier,Bolivia,1,-1
1866,10/13/2020,Chile,Colombia,2,2,World Cup qualifier,Chile,1,0
1867,10/13/2020,Peru,Brazil,2,4,World Cup qualifier,Peru,1,-2
1868,10/13/2020,Venezuela,Paraguay,0,1,World Cup qualifier,Venezuela,1,-1
1869,10/13/2020,Germany,Switzerland,3,3,European Nations League A,Germany,1,0
1870,10/13/2020,Montenegro,Luxembourg,1,2,European Nations League C,Montenegro,1,-1
1871,10/13/2020,Ukraine,Spain,1,0,European Nations League A,Ukraine,1,1
1872,10/13/2020,Latvia,Malta,0,1,European Nations League D,Latvia,1,-1
1873,10/13/2020,Azerbaijan,Cyprus,0,0,European Nations League C,Albania,0,0
1874,10/13/2020,Faroe Islands,Andorra,2,0,European Nations League D,Faroe Islands,1,2
1875,10/13/2020,Liechtenstein,San Marino,0,0,European Nations League D,Liechtenstein,1,0
1876,10/14/2020,Scotland,Czechia,1,0,European Nations League B,Scotland,1,1
1877,10/14/2020,England,Denmark,0,1,European Nations League A,England,1,-1
1878,10/14/2020,Bulgaria,Wales,0,1,European Nations League B,Bulgaria,1,-1
1879,10/14/2020,Norway,Northern Ireland,1,0,European Nations League B,Norway,1,1
1880,10/14/2020,Romania,Austria,0,1,European Nations League B,Romania,1,-1
1881,10/14/2020,Russia,Hungary,0,0,European Nations League B,Russia,1,0
1882,10/14/2020,Iceland,Belgium,1,2,European Nations League A,Iceland,1,-1
1883,10/14/2020,Croatia,France,1,2,European Nations League A,Croatia,1,-1
1884,10/14/2020,Italy,Netherlands,1,1,European Nations League A,Italy,1,0
1885,10/14/2020,Portugal,Sweden,3,0,European Nations League A,Portugal,1,3
1886,10/14/2020,Finland,Ireland,1,0,European Nations League B,Finland,1,1
1887,10/14/2020,Estonia,Armenia,1,1,European Nations League C,Estonia,1,0
1888,10/14/2020,Poland,Bosnia and Herzegovina,3,0,European Nations League A,Poland,1,3
1889,10/14/2020,Lithuania,Albania,0,0,European Nations League C,Lithuania,1,0
1890,10/14/2020,Turkey,Serbia,2,2,European Nations League B,Turkey,1,0
1891,10/14/2020,Belarus,Kazakhstan,2,0,European Nations League C,Belarus,1,2
1892,10/14/2020,Greece,Kosovo,0,0,European Nations League C,Greece,1,0
1893,10/14/2020,Slovakia,Israel,2,3,European Nations League B,Slovakia,1,-1
1894,10/14/2020,Moldova,Slovenia,0,4,European Nations League C,Moldova,1,-4
1895,10/14/2020,North Macedonia,Georgia,1,1,European Nations League C,North Macedonia,1,0
1896,10/22/2020,Ethiopia,Zambia,2,3,Friendly,Ethiopia,1,-1
1897,10/25/2020,Ethiopia,Zambia,1,3,Friendly,Ethiopia,1,-2
1898,11/6/2020,Ethiopia,Sudan,2,2,Friendly,Ethiopia,1,0
1899,11/7/2020,Bahrain,Tajikistan,1,0,Friendly,United Arab Emirates,0,1
1900,11/11/2020,Kenya,Comoros,1,1,African Nations Cup qualifier,Kenya,1,0
1901,11/11/2020,Senegal,Guinea-Bissau,2,0,African Nations Cup qualifier,Senegal,1,2
1902,11/11/2020,Mauritania,Burundi,1,1,African Nations Cup qualifier,Mauritania,1,0
1903,11/11/2020,Equatorial Guinea,Libya,3,2,African Nations Cup qualifier,Tunisia,0,1
1904,11/11/2020,Guinea,Chad,1,0,African Nations Cup qualifier,Guinea,1,1
1905,11/11/2020,Luxembourg,Austria,0,3,Friendly,Luxembourg,1,-3
1906,11/11/2020,Belgium,Switzerland,2,1,Friendly,Belgium,1,1
1907,11/11/2020,France,Finland,0,2,Friendly,France,1,-2
1908,11/11/2020,Netherlands,Spain,1,1,Friendly,Netherlands,1,0
1909,11/11/2020,Germany,Czechia,1,0,Friendly,Germany,1,1
1910,11/11/2020,Denmark,Sweden,2,0,Friendly,Denmark,1,2
1911,11/11/2020,Italy,Estonia,4,0,Friendly,Italy,1,4
1912,11/11/2020,Poland,Ukraine,2,0,Friendly,Poland,1,2
1913,11/11/2020,Portugal,Andorra,7,0,Friendly,Portugal,1,7
1914,11/11/2020,Romania,Belarus,5,3,Friendly,Romania,1,2
1915,11/11/2020,San Marino,Latvia,0,3,Friendly,San Marino,1,-3
1916,11/11/2020,Lithuania,Faroe Islands,2,1,Friendly,Lithuania,1,1
1917,11/11/2020,Turkey,Croatia,3,3,Friendly,Turkey,1,0
1918,11/11/2020,Bulgaria,Gibraltar,3,0,Friendly,Bulgaria,1,3
1919,11/11/2020,Greece,Cyprus,2,1,Friendly,Greece,1,1
1920,11/11/2020,Albania,Kosovo,2,1,Friendly,Albania,1,1
1921,11/11/2020,Montenegro,Kazakhstan,0,0,Friendly,Montenegro,1,0
1922,11/11/2020,Malta,Liechtenstein,3,0,Friendly,Malta,1,3
1923,11/11/2020,Slovenia,Azerbaijan,0,0,Friendly,Slovenia,1,0
1924,11/12/2020,Bahrain,Lebanon,3,1,Friendly,United Arab Emirates,0,2
1925,11/12/2020,Bosnia and Herzegovina,Iran,0,2,Friendly,Bosnia and Herzegovina,1,-2
1926,11/12/2020,Syria,Uzbekistan,1,0,Friendly,United Arab Emirates,0,1
1927,11/12/2020,Iraq,Jordan,0,0,Friendly,United Arab Emirates,0,0
1928,11/12/2020,United Arab Emirates,Tajikistan,3,2,Friendly,United Arab Emirates,1,1
1929,11/12/2020,Uganda,South Sudan,1,0,African Nations Cup qualifier,Uganda,1,1
1930,11/12/2020,Algeria,Zimbabwe,3,1,African Nations Cup qualifier,Algeria,1,2
1931,11/12/2020,Zambia,Botswana,2,1,African Nations Cup qualifier,Zambia,1,1
1932,11/12/2020,Ivory Coast,Madagascar,2,1,African Nations Cup qualifier,Ivory Coast,1,1
1933,11/12/2020,Ghana,Sudan,2,0,African Nations Cup qualifier,Ghana,1,2
1934,11/12/2020,Gabon,Gambia,2,1,African Nations Cup qualifier,Gabon,1,1
1935,11/12/2020,Burkina Faso,Malawi,3,1,African Nations Cup qualifier,Burkina Faso,1,2
1936,11/12/2020,Cape Verde,Rwanda,0,0,African Nations Cup qualifier,Cape Verde,1,0
1937,11/12/2020,Cameroon,Mozambique,4,1,African Nations Cup qualifier,Cameroon,1,3
1938,11/12/2020,Congo,Eswatini,2,0,African Nations Cup qualifier,Congo,1,2
1939,11/12/2020,Wales,United States,0,0,Friendly,Wales,1,0
1940,11/12/2020,Argentina,Paraguay,1,1,World Cup qualifier,Argentina,1,0
1941,11/12/2020,Bolivia,Ecuador,2,3,World Cup qualifier,Bolivia,1,-1
1942,11/12/2020,Serbia,Scotland,1,1,European Championship qual,Serbia,1,0
1943,11/12/2020,England,Ireland,3,0,Friendly,England,1,3
1944,11/12/2020,Northern Ireland,Slovakia,1,2,European Championship qual,Northern Ireland,1,-1
1945,11/12/2020,Hungary,Iceland,2,1,European Championship qual,Hungary,1,1
1946,11/12/2020,Moldova,Russia,0,0,Friendly,Moldova,1,0
1947,11/12/2020,Georgia,North Macedonia,0,1,European Championship qual,Georgia,1,-1
1948,11/13/2020,Japan,Panama,1,0,Friendly,Austria,0,1
1949,11/13/2020,Costa Rica,Qatar,1,1,Friendly,Austria,0,0
1950,11/13/2020,Bangladesh,Nepal,2,0,Friendly,Bangladesh,1,2
1951,11/13/2020,South Africa,São Tomé and Príncipe,2,0,African Nations Cup qualifier,South Africa,1,2
1952,11/13/2020,Tunisia,Tanzania,1,0,African Nations Cup qualifier,Tunisia,1,1
1953,11/13/2020,Niger,Ethiopia,1,0,African Nations Cup qualifier,Niger,1,1
1954,11/13/2020,Nigeria,Sierra Leone,4,4,African Nations Cup qualifier,Nigeria,1,0
1955,11/13/2020,Morocco,Central African Republic,4,1,African Nations Cup qualifier,Morocco,1,3
1956,11/13/2020,Mali,Namibia,1,0,African Nations Cup qualifier,Mali,1,1
1957,11/13/2020,Colombia,Uruguay,0,3,World Cup qualifier,Colombia,1,-3
1958,11/13/2020,Chile,Peru,2,0,World Cup qualifier,Chile,1,2
1959,11/13/2020,Brazil,Venezuela,1,0,World Cup qualifier,Brazil,1,1
1960,11/14/2020,Mexico,South Korea,3,2,Friendly,Austria,0,1
1961,11/14/2020,Saudi Arabia,Jamaica,3,0,Friendly,Saudi Arabia,1,3
1962,11/14/2020,Egypt,Togo,1,0,African Nations Cup qualifier,Egypt,1,1
1963,11/14/2020,DR Congo,Angola,0,0,African Nations Cup qualifier,DR Congo,1,0
1964,11/14/2020,Benin,Lesotho,1,0,African Nations Cup qualifier,Benin,1,1
1965,11/14/2020,Portugal,France,0,1,European Nations League A,Portugal,1,-1
1966,11/14/2020,Switzerland,Spain,1,1,European Nations League A,Switzerland,1,0
1967,11/14/2020,Germany,Ukraine,3,1,European Nations League A,Germany,1,2
1968,11/14/2020,Sweden,Croatia,2,1,European Nations League A,Sweden,1,1
1969,11/14/2020,Cyprus,Luxembourg,2,1,European Nations League C,Cyprus,1,1
1970,11/14/2020,Latvia,Faroe Islands,1,1,European Nations League D,Latvia,1,0
1971,11/14/2020,Azerbaijan,Montenegro,0,0,European Nations League C,Croatia,0,0
1972,11/14/2020,Malta,Andorra,3,1,European Nations League D,Malta,1,2
1973,11/14/2020,San Marino,Gibraltar,0,0,European Nations League D,San Marino,1,0
1974,11/15/2020,Comoros,Kenya,2,1,African Nations Cup qualifier,Comoros,1,1
1975,11/15/2020,Guinea-Bissau,Senegal,0,1,African Nations Cup qualifier,Guinea-Bissau,1,-1
1976,11/15/2020,Burundi,Mauritania,3,1,African Nations Cup qualifier,Burundi,1,2
1977,11/15/2020,Equatorial Guinea,Libya,1,0,African Nations Cup qualifier,Equatorial Guinea,1,1
1978,11/15/2020,Chad,Guinea,1,1,African Nations Cup qualifier,Chad,1,0
1979,11/15/2020,Guatemala,Honduras,2,1,Friendly,Guatemala,1,1
1980,11/15/2020,Slovakia,Scotland,1,0,European Nations League B,Slovakia,1,1
1981,11/15/2020,Belgium,England,2,0,European Nations League A,Belgium,1,2
1982,11/15/2020,Wales,Ireland,1,0,European Nations League B,Wales,1,1
1983,11/15/2020,Austria,Northern Ireland,2,1,European Nations League B,Austria,1,1
1984,11/15/2020,Hungary,Serbia,1,1,European Nations League B,Hungary,1,0
1985,11/15/2020,Netherlands,Bosnia and Herzegovina,3,1,European Nations League A,Netherlands,1,2
1986,11/15/2020,Italy,Poland,2,0,European Nations League A,Italy,1,2
1987,11/15/2020,Bulgaria,Finland,1,2,European Nations League B,Bulgaria,1,-1
1988,11/15/2020,Turkey,Russia,3,2,European Nations League B,Turkey,1,1
1989,11/15/2020,Denmark,Iceland,2,1,European Nations League A,Denmark,1,1
1990,11/15/2020,North Macedonia,Estonia,2,1,European Nations League C,North Macedonia,1,1
1991,11/15/2020,Belarus,Lithuania,2,0,European Nations League C,Belarus,1,2
1992,11/15/2020,Moldova,Greece,0,2,European Nations League C,Moldova,1,-2
1993,11/15/2020,Czechia,Israel,1,0,European Nations League B,Czechia,1,1
1994,11/15/2020,Albania,Kazakhstan,3,1,European Nations League C,Albania,1,2
1995,11/15/2020,Georgia,Armenia,1,2,European Nations League C,Georgia,1,-1
1996,11/15/2020,Slovenia,Kosovo,2,1,European Nations League C,Slovenia,1,1
1997,11/16/2020,Jordan,Syria,1,0,Friendly,United Arab Emirates,0,1
1998,11/16/2020,United Arab Emirates,Bahrain,1,3,Friendly,United Arab Emirates,1,-2
1999,11/16/2020,South Africa,São Tomé and Príncipe,4,2,African Nations Cup qualifier,South Africa,1,2
2000,11/16/2020,South Sudan,Uganda,1,0,African Nations Cup qualifier,Kenya,0,1
2001,11/16/2020,Zimbabwe,Algeria,2,2,African Nations Cup qualifier,Zimbabwe,1,0
2002,11/16/2020,Botswana,Zambia,1,0,African Nations Cup qualifier,Botswana,1,1
2003,11/16/2020,Gambia,Gabon,2,1,African Nations Cup qualifier,The Gambia,0,1
2004,11/16/2020,Malawi,Burkina Faso,0,0,African Nations Cup qualifier,Malawi,1,0
2005,11/16/2020,Mozambique,Cameroon,0,2,African Nations Cup qualifier,Mozambique,1,-2
2006,11/16/2020,Eswatini,Congo,0,0,African Nations Cup qualifier,Eswatini,1,0
2007,11/16/2020,United States,Panama,6,2,Friendly,Austria,0,4
2008,11/17/2020,Mexico,Japan,2,0,Friendly,Austria,0,2
2009,11/17/2020,South Korea,Qatar,2,1,Friendly,Austria,0,1
2010,11/17/2020,Iraq,Uzbekistan,2,1,Friendly,United Arab Emirates,0,1
2011,11/17/2020,Saudi Arabia,Jamaica,1,2,Friendly,Saudi Arabia,1,-1
2012,11/17/2020,Bangladesh,Nepal,0,0,Friendly,Bangladesh,1,0
2013,11/17/2020,Togo,Egypt,1,3,African Nations Cup qualifier,Togo,1,-2
2014,11/17/2020,Tanzania,Tunisia,1,1,African Nations Cup qualifier,Tanzania,1,0
2015,11/17/2020,Madagascar,Ivory Coast,1,1,African Nations Cup qualifier,Madagascar,1,0
2016,11/17/2020,Ethiopia,Niger,3,0,African Nations Cup qualifier,Ethiopia,1,3
2017,11/17/2020,Angola,DR Congo,0,1,African Nations Cup qualifier,Angola,1,-1
2018,11/17/2020,Sierra Leone,Nigeria,0,0,African Nations Cup qualifier,Sierra Leone,1,0
2019,11/17/2020,Sudan,Ghana,1,0,African Nations Cup qualifier,Sudan,1,1
2020,11/17/2020,Central African Republic,Morocco,0,2,African Nations Cup qualifier,Cameroon,0,-2
2021,11/17/2020,Lesotho,Benin,0,0,African Nations Cup qualifier,Lesotho,1,0
2022,11/17/2020,Rwanda,Cape Verde,0,0,African Nations Cup qualifier,Rwanda,1,0
2023,11/17/2020,Namibia,Mali,1,2,African Nations Cup qualifier,Namibia,1,-1
2024,11/17/2020,Uruguay,Brazil,0,2,World Cup qualifier,Uruguay,1,-2
2025,11/17/2020,Peru,Argentina,0,2,World Cup qualifier,Peru,1,-2
2026,11/17/2020,Venezuela,Chile,2,1,World Cup qualifier,Venezuela,1,1
2027,11/17/2020,Paraguay,Bolivia,2,2,World Cup qualifier,Paraguay,1,0
2028,11/17/2020,Ecuador,Colombia,6,1,World Cup qualifier,Ecuador,1,5
2029,11/17/2020,France,Sweden,4,2,European Nations League A,France,1,2
2030,11/17/2020,Spain,Germany,6,0,European Nations League A,Spain,1,6
2031,11/17/2020,Luxembourg,Azerbaijan,0,0,European Nations League C,Luxembourg,1,0
2032,11/17/2020,Croatia,Portugal,2,3,European Nations League A,Croatia,1,-1
2033,11/17/2020,Andorra,Latvia,0,5,European Nations League D,Andorra,1,-5
2034,11/17/2020,Montenegro,Cyprus,4,0,European Nations League C,Montenegro,1,4
2035,11/17/2020,Malta,Faroe Islands,1,1,European Nations League D,Malta,1,0
2036,11/17/2020,Gibraltar,Liechtenstein,1,1,European Nations League D,Gibraltar,1,0
2037,11/18/2020,Israel,Scotland,1,0,European Nations League B,Israel,1,1
2038,11/18/2020,England,Iceland,4,0,European Nations League A,England,1,4
2039,11/18/2020,Wales,Finland,3,1,European Nations League B,Wales,1,2
2040,11/18/2020,Northern Ireland,Romania,1,1,European Nations League B,Northern Ireland,1,0
2041,11/18/2020,Austria,Norway,1,1,European Nations League B,Austria,1,0
2042,11/18/2020,Hungary,Turkey,2,0,European Nations League B,Hungary,1,2
2043,11/18/2020,Belgium,Denmark,4,2,European Nations League A,Belgium,1,2
2044,11/18/2020,Poland,Netherlands,1,2,European Nations League A,Poland,1,-1
2045,11/18/2020,Bosnia and Herzegovina,Italy,0,2,European Nations League A,Bosnia and Herzegovina,1,-2
2046,11/18/2020,Serbia,Russia,5,0,European Nations League B,Serbia,1,5
2047,11/18/2020,Georgia,Estonia,0,0,European Nations League C,Georgia,1,0
2048,11/18/2020,Kazakhstan,Lithuania,1,2,European Nations League C,Kazakhstan,1,-1
2049,11/18/2020,Ireland,Bulgaria,0,0,European Nations League B,Ireland,1,0
2050,11/18/2020,Albania,Belarus,3,2,European Nations League C,Albania,1,1
2051,11/18/2020,Greece,Slovenia,0,0,European Nations League C,Greece,1,0
2052,11/18/2020,Czechia,Slovakia,2,0,European Nations League B,Czechia,1,2
2053,11/18/2020,Kosovo,Moldova,1,0,European Nations League C,Kosovo,1,1
2054,11/18/2020,Armenia,North Macedonia,1,0,European Nations League C,Cyprus,0,1
2055,12/4/2020,Qatar,Bangladesh,5,0,World Cup and Asian Cup qual,Qatar,1,5
2056,12/9/2020,United States,El Salvador,6,0,Friendly,United States,1,6
2057,1/12/2021,United Arab Emirates,Iraq,0,0,Friendly,United Arab Emirates,1,0
2058,1/18/2021,Kuwait,Palestine,0,1,Friendly,Kuwait,1,-1
2059,1/19/2021,Dominican Republic,Puerto Rico,0,1,Friendly,Dominican Republic,1,-1
2060,1/22/2021,Guatemala,Puerto Rico,1,0,Friendly,Guatemala,1,1
2061,1/25/2021,Dominican Republic,Serbia,0,0,Friendly,Dominican Republic,1,0
2062,1/27/2021,Iraq,Kuwait,2,1,Friendly,Iraq,1,1
2063,1/28/2021,Panama,Serbia,0,0,Friendly,Panama,1,0
2064,1/31/2021,United States,Trinidad and Tobago,7,0,Friendly,United States,1,7
2065,2/1/2021,Jordan,Tajikistan,2,0,Friendly,United Arab Emirates,0,2
2066,2/5/2021,Tajikistan,Jordan,1,0,Friendly,United Arab Emirates,0,1
2067,2/15/2021,Uzbekistan,Jordan,2,0,Friendly,United Arab Emirates,0,2
2068,2/24/2021,Guatemala,Nicaragua,1,0,Friendly,Guatemala,1,1
2069,3/5/2021,Bermuda,Bahamas,3,0,Friendly,United States,0,3
2070,3/7/2021,Bahamas,Bermuda,0,0,Friendly,United States,0,0
2071,3/13/2021,Kenya,South Sudan,1,0,Friendly,Kenya,1,1
2072,3/15/2021,Kenya,Tanzania,2,1,Friendly,Kenya,1,1
2073,3/17/2021,Ethiopia,Malawi,4,0,Friendly,Ethiopia,1,4
2074,3/19/2021,Barbados,Turks and Caicos Islands,2,0,Friendly,Dominican Republic,0,2
2075,3/20/2021,Jordan,Oman,0,0,Friendly,United Arab Emirates,0,0
2076,3/21/2021,Antigua and Barbuda,British Virgin Islands,3,0,Friendly,Curaçao,0,3
2077,3/21/2021,Anguilla,US Virgin Islands,0,0,Friendly,United States,0,0
2078,3/24/2021,Jordan,Lebanon,1,0,Friendly,United Arab Emirates,0,1
2079,3/24/2021,Qatar,Luxembourg,1,0,Friendly,Hungary,0,1
2080,3/24/2021,Uganda,Burkina Faso,0,0,African Nations Cup qualifier,Uganda,1,0
2081,3/24/2021,Ethiopia,Madagascar,4,0,African Nations Cup qualifier,Ethiopia,1,4
2082,3/24/2021,São Tomé and Príncipe,Sudan,0,2,African Nations Cup qualifier,São Tomé and Príncipe,1,-2
2083,3/24/2021,Malawi,South Sudan,1,0,African Nations Cup qualifier,Sudan,0,1
2084,3/24/2021,Guinea,Mali,1,0,African Nations Cup qualifier,Guinea,1,1
2085,3/24/2021,Rwanda,Mozambique,1,0,African Nations Cup qualifier,Rwanda,1,1
2086,3/24/2021,Guatemala,Cuba,1,0,World Cup qualifier,Guatemala,1,1
2087,3/24/2021,Belarus,Honduras,1,1,Friendly,Belarus,1,0
2088,3/24/2021,Dominican Republic,Dominica,1,0,World Cup qualifier,Dominican Republic,1,1
2089,3/24/2021,Suriname,Cayman Islands,3,0,World Cup qualifier,Suriname,1,3
2090,3/24/2021,Saint Kitts and Nevis,Puerto Rico,1,0,World Cup qualifier,Dominican Republic,0,1
2091,3/24/2021,Antigua and Barbuda,Montserrat,2,2,World Cup qualifier,Curaçao,0,0
2092,3/24/2021,Belgium,Wales,3,1,World Cup qualifier,Belgium,1,2
2093,3/24/2021,France,Ukraine,1,1,World Cup qualifier,France,1,0
2094,3/24/2021,Turkey,Netherlands,4,2,World Cup qualifier,Turkey,1,2
2095,3/24/2021,Gibraltar,Norway,0,3,World Cup qualifier,Gibraltar,1,-3
2096,3/24/2021,Finland,Bosnia and Herzegovina,2,2,World Cup qualifier,Finland,1,0
2097,3/24/2021,Malta,Russia,1,3,World Cup qualifier,Malta,1,-2
2098,3/24/2021,Czechia,Estonia,6,2,World Cup qualifier,Poland,0,4
2099,3/24/2021,Portugal,Azerbaijan,1,0,World Cup qualifier,Italy,0,1
2100,3/24/2021,Latvia,Montenegro,1,2,World Cup qualifier,Latvia,1,-1
2101,3/24/2021,Kosovo,Lithuania,4,0,Friendly,Kosovo,1,4
2102,3/24/2021,Serbia,Ireland,3,2,World Cup qualifier,Serbia,1,1
2103,3/24/2021,Cyprus,Slovakia,0,0,World Cup qualifier,Cyprus,1,0
2104,3/24/2021,Slovenia,Croatia,1,0,World Cup qualifier,Slovenia,1,1
2105,3/25/2021,Japan,South Korea,3,0,Friendly,Japan,1,3
2106,3/25/2021,India,Oman,1,1,Friendly,United Arab Emirates,0,0
2107,3/25/2021,Tajikistan,Mongolia,3,0,World Cup and Asian Cup qual,Tajikistan,1,3
2108,3/25/2021,Bahrain,Syria,3,1,Friendly,Bahrain,1,2
2109,3/25/2021,Saudi Arabia,Kuwait,1,0,Friendly,Saudi Arabia,1,1
2110,3/25/2021,Kenya,Egypt,1,1,African Nations Cup qualifier,Kenya,1,0
2111,3/25/2021,South Africa,Ghana,1,1,African Nations Cup qualifier,South Africa,1,0
2112,3/25/2021,Equatorial Guinea,Tanzania,1,0,African Nations Cup qualifier,Equatorial Guinea,1,1
2113,3/25/2021,Botswana,Zimbabwe,0,1,African Nations Cup qualifier,Botswana,1,-1
2114,3/25/2021,Zambia,Algeria,3,3,African Nations Cup qualifier,Zambia,1,0
2115,3/25/2021,Gabon,DR Congo,3,0,African Nations Cup qualifier,Gabon,1,3
2116,3/25/2021,Gambia,Angola,1,0,African Nations Cup qualifier,The Gambia,0,1
2117,3/25/2021,Comoros,Togo,0,0,African Nations Cup qualifier,Comoros,1,0
2118,3/25/2021,Libya,Tunisia,2,5,African Nations Cup qualifier,Libya,1,-3
2119,3/25/2021,United States,Jamaica,4,1,Friendly,Austria,0,3
2120,3/25/2021,Canada,Bermuda,5,1,World Cup qualifier,United States,0,4
2121,3/25/2021,El Salvador,Grenada,2,0,World Cup qualifier,El Salvador,1,2
2122,3/25/2021,Curaçao,St Vincent & Grenadines,5,0,World Cup qualifier,Curaçao,1,5
2123,3/25/2021,Haiti,Belize,2,0,World Cup qualifier,Haiti,1,2
2124,3/25/2021,Trinidad and Tobago,Guyana,3,0,World Cup qualifier,Dominican Republic,0,3
2125,3/25/2021,Panama,Barbados,1,0,World Cup qualifier,Dominican Republic,0,1
2126,3/25/2021,Scotland,Austria,2,2,World Cup qualifier,Scotland,1,0
2127,3/25/2021,England,San Marino,5,0,World Cup qualifier,England,1,5
2128,3/25/2021,Italy,Northern Ireland,2,0,World Cup qualifier,Italy,1,2
2129,3/25/2021,Hungary,Poland,3,3,World Cup qualifier,Hungary,1,0
2130,3/25/2021,Bulgaria,Switzerland,1,3,World Cup qualifier,Bulgaria,1,-2
2131,3/25/2021,Germany,Iceland,3,0,World Cup qualifier,Germany,1,3
2132,3/25/2021,Sweden,Georgia,1,0,World Cup qualifier,Sweden,1,1
2133,3/25/2021,Israel,Denmark,0,2,World Cup qualifier,Israel,1,-2
2134,3/25/2021,Spain,Greece,1,1,World Cup qualifier,Spain,1,0
2135,3/25/2021,Romania,North Macedonia,3,2,World Cup qualifier,Romania,1,1
2136,3/25/2021,Andorra,Albania,0,1,World Cup qualifier,Andorra,1,-1
2137,3/25/2021,Moldova,Faroe Islands,1,1,World Cup qualifier,Moldova,1,0
2138,3/25/2021,Liechtenstein,Armenia,0,1,World Cup qualifier,Liechtenstein,1,-1
2139,3/26/2021,Eswatini,Guinea-Bissau,1,3,African Nations Cup qualifier,Eswatini,1,-2
2140,3/26/2021,Burundi,Central African Republic,2,2,African Nations Cup qualifier,Burundi,1,0
2141,3/26/2021,Mauritania,Morocco,0,0,African Nations Cup qualifier,Mauritania,1,0
2142,3/26/2021,Cape Verde,Cameroon,3,1,African Nations Cup qualifier,Cape Verde,1,2
2143,3/26/2021,Niger,Ivory Coast,0,3,African Nations Cup qualifier,Niger,1,-3
2144,3/26/2021,Congo,Senegal,0,0,African Nations Cup qualifier,Congo,1,0
2145,3/26/2021,Chile,Bolivia,2,1,Friendly,Chile,1,1
2146,3/27/2021,Qatar,Azerbaijan,2,1,Friendly,Hungary,0,1
2147,3/27/2021,Nepal,Bangladesh,0,0,Friendly tournament,Nepal,1,0
2148,3/27/2021,Lesotho,Sierra Leone,0,0,African Nations Cup qualifier,Lesotho,1,0
2149,3/27/2021,Benin,Nigeria,0,1,African Nations Cup qualifier,Benin,1,-1
2150,3/27/2021,Bosnia and Herzegovina,Costa Rica,0,0,Friendly,Bosnia and Herzegovina,1,0
2151,3/27/2021,Guatemala,British Virgin Islands,3,0,World Cup qualifier,Curaçao,0,3
2152,3/27/2021,Wales,Mexico,1,0,Friendly,Wales,1,1
2153,3/27/2021,Suriname,Aruba,6,0,World Cup qualifier,United States,0,6
2154,3/27/2021,Nicaragua,Turks and Caicos Islands,7,0,World Cup qualifier,Dominican Republic,0,7
2155,3/27/2021,Bahamas,Saint Kitts and Nevis,0,4,World Cup qualifier,Bahamas,1,-4
2156,3/27/2021,Dominican Republic,Anguilla,6,0,World Cup qualifier,United States,0,6
2157,3/27/2021,US Virgin Islands,Antigua and Barbuda,0,3,World Cup qualifier,US Virgin Islands,1,-3
2158,3/27/2021,Czechia,Belgium,1,1,World Cup qualifier,Czechia,1,0
2159,3/27/2021,Netherlands,Latvia,2,0,World Cup qualifier,Netherlands,1,2
2160,3/27/2021,Norway,Turkey,0,3,World Cup qualifier,Spain,0,-3
2161,3/27/2021,Ireland,Luxembourg,0,1,World Cup qualifier,Ireland,1,-1
2162,3/27/2021,Russia,Slovenia,2,1,World Cup qualifier,Russia,1,1
2163,3/27/2021,Belarus,Estonia,4,2,World Cup qualifier,Belarus,1,2
2164,3/27/2021,Serbia,Portugal,2,2,World Cup qualifier,Serbia,1,0
2165,3/27/2021,Slovakia,Malta,2,2,World Cup qualifier,Slovakia,1,0
2166,3/27/2021,Croatia,Cyprus,1,0,World Cup qualifier,Croatia,1,1
2167,3/27/2021,Montenegro,Gibraltar,4,1,World Cup qualifier,Montenegro,1,3
2168,3/28/2021,Sudan,South Africa,2,0,African Nations Cup qualifier,Sudan,1,2
2169,3/28/2021,Tanzania,Libya,1,0,African Nations Cup qualifier,Tanzania,1,1
2170,3/28/2021,Ghana,São Tomé and Príncipe,3,1,African Nations Cup qualifier,Ghana,1,2
2171,3/28/2021,Tunisia,Equatorial Guinea,2,1,African Nations Cup qualifier,Tunisia,1,1
2172,3/28/2021,Namibia,Guinea,2,1,African Nations Cup qualifier,Namibia,1,1
2173,3/28/2021,Northern Ireland,United States,1,2,Friendly,Northern Ireland,1,-1
2174,3/28/2021,El Salvador,Montserrat,1,1,World Cup qualifier,Curaçao,0,0
2175,3/28/2021,Curaçao,Cuba,2,1,World Cup qualifier,Guatemala,0,1
2176,3/28/2021,Greece,Honduras,2,1,Friendly,Greece,1,1
2177,3/28/2021,Puerto Rico,Trinidad and Tobago,1,1,World Cup qualifier,Puerto Rico,1,0
2178,3/28/2021,Panama,Dominica,2,1,World Cup qualifier,Dominican Republic,0,1
2179,3/28/2021,Israel,Scotland,1,1,World Cup qualifier,Israel,1,0
2180,3/28/2021,Albania,England,0,2,World Cup qualifier,Albania,1,-2
2181,3/28/2021,Austria,Faroe Islands,3,1,World Cup qualifier,Austria,1,2
2182,3/28/2021,San Marino,Hungary,0,3,World Cup qualifier,San Marino,1,-3
2183,3/28/2021,Kazakhstan,France,0,2,World Cup qualifier,Kazakhstan,1,-2
2184,3/28/2021,Switzerland,Lithuania,1,0,World Cup qualifier,Switzerland,1,1
2185,3/28/2021,Romania,Germany,0,1,World Cup qualifier,Romania,1,-1
2186,3/28/2021,Kosovo,Sweden,0,3,World Cup qualifier,Kosovo,1,-3
2187,3/28/2021,Bulgaria,Italy,0,2,World Cup qualifier,Bulgaria,1,-2
2188,3/28/2021,Ukraine,Finland,1,1,World Cup qualifier,Ukraine,1,0
2189,3/28/2021,Denmark,Moldova,8,0,World Cup qualifier,Denmark,1,8
2190,3/28/2021,Poland,Andorra,3,0,World Cup qualifier,Poland,1,3
2191,3/28/2021,Georgia,Spain,1,2,World Cup qualifier,Georgia,1,-1
2192,3/28/2021,Armenia,Iceland,2,0,World Cup qualifier,Armenia,1,2
2193,3/28/2021,North Macedonia,Liechtenstein,5,0,World Cup qualifier,North Macedonia,1,5
2194,3/29/2021,United Arab Emirates,India,6,0,Friendly,United Arab Emirates,1,6
2195,3/29/2021,Kuwait,Lebanon,1,1,Friendly,United Arab Emirates,0,0
2196,3/29/2021,Uzbekistan,Iraq,0,1,Friendly,Uzbekistan,1,-1
2197,3/29/2021,Nepal,Bangladesh,2,1,Friendly tournament,Nepal,1,1
2198,3/29/2021,Egypt,Comoros,4,0,African Nations Cup qualifier,Egypt,1,4
2199,3/29/2021,Togo,Kenya,1,2,African Nations Cup qualifier,Togo,1,-1
2200,3/29/2021,Malawi,Uganda,1,0,African Nations Cup qualifier,Malawi,1,1
2201,3/29/2021,Zimbabwe,Zambia,0,2,African Nations Cup qualifier,Zimbabwe,1,-2
2202,3/29/2021,DR Congo,Gambia,1,0,African Nations Cup qualifier,DR Congo,1,1
2203,3/29/2021,Angola,Gabon,2,0,African Nations Cup qualifier,Angola,1,2
2204,3/29/2021,Burkina Faso,South Sudan,1,0,African Nations Cup qualifier,Burkina Faso,1,1
2205,3/29/2021,Algeria,Botswana,5,0,African Nations Cup qualifier,Algeria,1,5
2206,3/29/2021,Canada,Cayman Islands,11,0,World Cup qualifier,United States,0,11
2207,3/29/2021,Ecuador,Bolivia,2,1,Friendly,Ecuador,1,1
2208,3/30/2021,Japan,Mongolia,14,0,World Cup and Asian Cup qual,Japan,1,14
2209,3/30/2021,Iran,Syria,3,0,Friendly,Iran,1,3
2210,3/30/2021,Bahrain,Jordan,1,2,Friendly,Bahrain,1,-1
2211,3/30/2021,Saudi Arabia,Palestine,5,0,World Cup and Asian Cup qual,Saudi Arabia,1,5
2212,3/30/2021,Ireland,Qatar,1,1,Friendly,Hungary,0,0
2213,3/30/2021,Madagascar,Niger,0,0,African Nations Cup qualifier,Madagascar,1,0
2214,3/30/2021,Ivory Coast,Ethiopia,3,1,African Nations Cup qualifier,Ivory Coast,1,2
2215,3/30/2021,Nigeria,Lesotho,3,0,African Nations Cup qualifier,Nigeria,1,3
2216,3/30/2021,Guinea-Bissau,Congo,3,0,African Nations Cup qualifier,Guinea-Bissau,1,3
2217,3/30/2021,Morocco,Burundi,1,0,African Nations Cup qualifier,Morocco,1,1
2218,3/30/2021,Mozambique,Cape Verde,0,1,African Nations Cup qualifier,Mozambique,1,-1
2219,3/30/2021,Cameroon,Rwanda,0,0,African Nations Cup qualifier,Cameroon,1,0
2220,3/30/2021,Central African Republic,Mauritania,0,1,African Nations Cup qualifier,Central African Republic,1,-1
2221,3/30/2021,Senegal,Eswatini,1,1,African Nations Cup qualifier,Senegal,1,0
2222,3/30/2021,Mexico,Costa Rica,1,0,Friendly,Austria,0,1
2223,3/30/2021,Bermuda,Aruba,5,0,World Cup qualifier,Bermuda,1,5
2224,3/30/2021,Guyana,Bahamas,4,0,World Cup qualifier,Dominican Republic,0,4
2225,3/30/2021,Barbados,Anguilla,1,0,World Cup qualifier,Dominican Republic,0,1
2226,3/30/2021,Grenada,US Virgin Islands,1,0,World Cup qualifier,Grenada,1,1
2227,3/30/2021,St Vincent & Grenadines,British Virgin Islands,3,0,World Cup qualifier,Curaçao,0,3
2228,3/30/2021,Belize,Turks and Caicos Islands,5,0,World Cup qualifier,Dominican Republic,0,5
2229,3/30/2021,Wales,Czechia,1,0,World Cup qualifier,Wales,1,1
2230,3/30/2021,Belgium,Belarus,8,0,World Cup qualifier,Belgium,1,8
2231,3/30/2021,Gibraltar,Netherlands,0,7,World Cup qualifier,Gibraltar,1,-7
2232,3/30/2021,Montenegro,Norway,0,1,World Cup qualifier,Montenegro,1,-1
2233,3/30/2021,Luxembourg,Portugal,1,3,World Cup qualifier,Luxembourg,1,-2
2234,3/30/2021,Slovakia,Russia,2,1,World Cup qualifier,Slovakia,1,1
2235,3/30/2021,Turkey,Latvia,3,3,World Cup qualifier,Turkey,1,0
2236,3/30/2021,Croatia,Malta,3,0,World Cup qualifier,Croatia,1,3
2237,3/30/2021,Cyprus,Slovenia,1,0,World Cup qualifier,Cyprus,1,1
2238,3/30/2021,Azerbaijan,Serbia,1,2,World Cup qualifier,Azerbaijan,1,-1
2239,3/31/2021,Scotland,Faroe Islands,4,0,World Cup qualifier,Scotland,1,4
2240,3/31/2021,England,Poland,2,1,World Cup qualifier,England,1,1
2241,3/31/2021,Northern Ireland,Bulgaria,0,0,World Cup qualifier,Northern Ireland,1,0
2242,3/31/2021,Austria,Denmark,0,4,World Cup qualifier,Austria,1,-4
2243,3/31/2021,Andorra,Hungary,1,4,World Cup qualifier,Andorra,1,-3
2244,3/31/2021,Bosnia and Herzegovina,France,0,1,World Cup qualifier,Bosnia and Herzegovina,1,-1
2245,3/31/2021,Switzerland,Finland,3,2,Friendly,Switzerland,1,1
2246,3/31/2021,Germany,North Macedonia,1,2,World Cup qualifier,Germany,1,-1
2247,3/31/2021,Sweden,Estonia,1,0,Friendly,Sweden,1,1
2248,3/31/2021,Lithuania,Italy,0,2,World Cup qualifier,Lithuania,1,-2
2249,3/31/2021,Spain,Kosovo,3,1,World Cup qualifier,Spain,1,2
2250,3/31/2021,Armenia,Romania,3,2,World Cup qualifier,Armenia,1,1
2251,3/31/2021,Ukraine,Kazakhstan,1,1,World Cup qualifier,Ukraine,1,0
2252,3/31/2021,Greece,Georgia,1,1,World Cup qualifier,Greece,1,0
2253,3/31/2021,Moldova,Israel,1,4,World Cup qualifier,Moldova,1,-3
2254,3/31/2021,Liechtenstein,Iceland,1,4,World Cup qualifier,Liechtenstein,1,-3
2255,3/31/2021,San Marino,Albania,0,2,World Cup qualifier,San Marino,1,-2
2256,4/28/2021,Sierra Leone,Liberia,0,2,Friendly tournament,Sierra Leone,1,-2
2257,5/23/2021,Kuwait,Malaysia,4,1,Friendly,United Arab Emirates,0,3
2258,5/23/2021,Ukraine,Bahrain,1,1,Friendly,Ukraine,1,0
2259,5/23/2021,Anguilla,US Virgin Islands,1,0,Friendly,Dominican Republic,0,1
2260,5/24/2021,Iraq,Tajikistan,0,0,Friendly,Iraq,1,0
2261,5/24/2021,United Arab Emirates,Jordan,5,1,Friendly,United Arab Emirates,1,4
2262,5/25/2021,Afghanistan,Indonesia,3,2,Friendly,United Arab Emirates,0,1
2263,5/25/2021,Oman,Thailand,1,0,Friendly,United Arab Emirates,0,1
2264,5/27/2021,Turkey,Azerbaijan,2,1,Friendly,Turkey,1,1
2265,5/28/2021,Japan,Myanmar,10,0,World Cup and Asian Cup qual,Japan,1,10
2266,5/28/2021,Bahrain,Malaysia,2,0,Friendly,Bahrain,1,2
2267,5/28/2021,Italy,San Marino,7,0,Friendly,Italy,1,7
2268,5/29/2021,Oman,Indonesia,3,1,Friendly,United Arab Emirates,0,2
2269,5/29/2021,Afghanistan,Singapore,1,1,Friendly,United Arab Emirates,0,0
2270,5/29/2021,Tajikistan,Thailand,2,2,Friendly,United Arab Emirates,0,0
2271,5/29/2021,Iraq,Nepal,6,2,Friendly,Iraq,1,4
2272,5/29/2021,Mexico,Iceland,2,1,Friendly,United States,0,1
2273,5/29/2021,Sweden,Finland,2,0,Friendly,Sweden,1,2
2274,5/30/2021,China,Guam,7,0,World Cup and Asian Cup qual,China,1,7
2275,5/30/2021,Uzbekistan,Thailand,4,1,Friendly,United Arab Emirates,0,3
2276,5/30/2021,Switzerland,United States,2,1,Friendly,Switzerland,1,1
2277,5/30/2021,Northern Ireland,Malta,3,0,Friendly,Austria,0,3
2278,5/31/2021,Jordan,Vietnam,1,1,Friendly,United Arab Emirates,0,0
2279,5/31/2021,Turkey,Guinea,0,0,Friendly,Turkey,1,0
2280,6/1/2021,Poland,Russia,1,1,Friendly,Poland,1,0
2281,6/1/2021,Lithuania,Estonia,0,1,Baltic Cup,Lithuania,1,-1
2282,6/1/2021,Bulgaria,Slovakia,1,1,Friendly,Austria,0,0
2283,6/1/2021,Croatia,Armenia,1,1,Friendly,Croatia,1,0
2284,6/1/2021,Kosovo,San Marino,4,1,Friendly,Kosovo,1,3
2285,6/1/2021,North Macedonia,Slovenia,1,1,Friendly,North Macedonia,1,0
2286,6/2/2021,Mozambique,Lesotho,5,0,Friendly tournament,Mozambique,1,5
2287,6/2/2021,Aruba,Cayman Islands,3,1,World Cup qualifier,United States,0,2
2288,6/2/2021,Dominica,Anguilla,3,0,World Cup qualifier,Dominican Republic,0,3
2289,6/2/2021,Cuba,British Virgin Islands,5,0,World Cup qualifier,Guatemala,0,5
2290,6/2/2021,Puerto Rico,Bahamas,7,0,World Cup qualifier,Puerto Rico,1,7
2291,6/2/2021,Montserrat,US Virgin Islands,4,0,World Cup qualifier,Dominican Republic,0,4
2292,6/2/2021,Netherlands,Scotland,2,2,Friendly,Portugal,0,0
2293,6/2/2021,England,Austria,1,0,Friendly,England,1,1
2294,6/2/2021,France,Wales,3,0,Friendly,France,1,3
2295,6/2/2021,Denmark,Germany,1,1,Friendly,Austria,0,0
2296,6/2/2021,Norway,Luxembourg,1,0,Friendly,Spain,0,1
2297,6/2/2021,Romania,Georgia,1,2,Friendly,Romania,1,-1
2298,6/2/2021,Belarus,Azerbaijan,1,2,Friendly,Belarus,1,-1
2299,6/2/2021,Bosnia and Herzegovina,Montenegro,0,0,Friendly,Bosnia and Herzegovina,1,0
2300,6/3/2021,Kuwait,Australia,0,3,World Cup and Asian Cup qual,Kuwait,1,-3
2301,6/3/2021,Indonesia,Thailand,2,2,World Cup and Asian Cup qual,United Arab Emirates,0,0
2302,6/3/2021,Qatar,India,1,0,World Cup and Asian Cup qual,Qatar,1,1
2303,6/3/2021,Afghanistan,Bangladesh,1,1,World Cup and Asian Cup qual,Qatar,0,0
2304,6/3/2021,Iran,Hong Kong,3,1,World Cup and Asian Cup qual,Bahrain,0,2
2305,6/3/2021,Nepal,Taiwan,2,0,World Cup and Asian Cup qual,Kuwait,0,2
2306,6/3/2021,Palestine,Singapore,4,0,World Cup and Asian Cup qual,Saudi Arabia,0,4
2307,6/3/2021,United Arab Emirates,Malaysia,4,0,World Cup and Asian Cup qual,United Arab Emirates,1,4
2308,6/3/2021,Bahrain,Cambodia,8,0,World Cup and Asian Cup qual,Bahrain,1,8
2309,6/3/2021,Algeria,Mauritania,4,1,Friendly,Algeria,1,3
2310,6/3/2021,United States,Honduras,1,0,CONCACAF Nations League,United States,1,1
2311,6/3/2021,Costa Rica,Mexico,0,0,CONCACAF Nations League,United States,0,0
2312,6/3/2021,Uruguay,Paraguay,0,0,World Cup qualifier,Uruguay,1,0
2313,6/3/2021,Argentina,Chile,1,1,World Cup qualifier,Argentina,1,0
2314,6/3/2021,Bolivia,Venezuela,3,1,World Cup qualifier,Bolivia,1,2
2315,6/3/2021,Peru,Colombia,0,3,World Cup qualifier,Peru,1,-3
2316,6/3/2021,Ukraine,Northern Ireland,1,0,Friendly,Ukraine,1,1
2317,6/3/2021,Belgium,Greece,1,1,Friendly,Belgium,1,0
2318,6/3/2021,Switzerland,Liechtenstein,7,0,Friendly,Switzerland,1,7
2319,6/3/2021,Turkey,Moldova,2,0,Friendly,Germany,0,2
2320,6/3/2021,Andorra,Ireland,1,4,Friendly,Andorra,1,-3
2321,6/4/2021,Syria,Maldives,4,0,World Cup and Asian Cup qual,United Arab Emirates,0,4
2322,6/4/2021,Cameroon,Nigeria,1,0,Friendly,Austria,0,1
2323,6/4/2021,Rwanda,Central African Republic,2,0,Friendly,Rwanda,1,2
2324,6/4/2021,Guatemala,St Vincent & Grenadines,10,0,World Cup qualifier,Guatemala,1,10
2325,6/4/2021,Saint Kitts and Nevis,Guyana,3,0,World Cup qualifier,Saint Kitts and Nevis,1,3
2326,6/4/2021,Dominican Republic,Barbados,1,1,World Cup qualifier,Dominican Republic,1,0
2327,6/4/2021,Nicaragua,Belize,3,0,World Cup qualifier,Nicaragua,1,3
2328,6/4/2021,Suriname,Bermuda,6,0,World Cup qualifier,Suriname,1,6
2329,6/4/2021,Antigua and Barbuda,Grenada,1,0,World Cup qualifier,Antigua and Barbuda,1,1
2330,6/4/2021,Brazil,Ecuador,2,0,World Cup qualifier,Brazil,1,2
2331,6/4/2021,Hungary,Cyprus,1,0,Friendly,Hungary,1,1
2332,6/4/2021,Italy,Czechia,4,0,Friendly,Italy,1,4
2333,6/4/2021,Finland,Estonia,0,1,Friendly,Finland,1,-1
2334,6/4/2021,Spain,Portugal,0,0,Friendly,Spain,1,0
2335,6/4/2021,Latvia,Lithuania,3,1,Baltic Cup,Latvia,1,2
2336,6/4/2021,Faroe Islands,Iceland,0,1,Friendly,Faroe Islands,1,-1
2337,6/4/2021,Kosovo,Malta,2,1,Friendly,Austria,0,1
2338,6/4/2021,North Macedonia,Kazakhstan,4,0,Friendly,North Macedonia,1,4
2339,6/4/2021,Slovenia,Gibraltar,6,0,Friendly,Slovenia,1,6
2340,6/5/2021,Lebanon,Sri Lanka,3,2,World Cup and Asian Cup qual,South Korea,0,1
2341,6/5/2021,South Korea,Turkmenistan,5,0,World Cup and Asian Cup qual,South Korea,1,5
2342,6/5/2021,Saudi Arabia,Yemen,3,0,World Cup and Asian Cup qual,Saudi Arabia,1,3
2343,6/5/2021,Senegal,Zambia,3,1,Friendly,Senegal,1,2
2344,6/5/2021,Tunisia,DR Congo,1,0,Friendly,Tunisia,1,1
2345,6/5/2021,Gambia,Niger,2,0,Friendly,Turkey,0,2
2346,6/5/2021,Togo,Guinea,2,0,Friendly,Turkey,0,2
2347,6/5/2021,Ivory Coast,Burkina Faso,2,1,Friendly,Ivory Coast,1,1
2348,6/5/2021,Eswatini,Lesotho,1,0,Friendly tournament,Mozambique,0,1
2349,6/5/2021,Canada,Aruba,7,0,World Cup qualifier,United States,0,7
2350,6/5/2021,US Virgin Islands,El Salvador,0,7,World Cup qualifier,US Virgin Islands,1,-7
2351,6/5/2021,Curaçao,British Virgin Islands,8,0,World Cup qualifier,Guatemala,0,8
2352,6/5/2021,Turks and Caicos Islands,Haiti,0,10,World Cup qualifier,Turks and Caicos Islands,1,-10
2353,6/5/2021,Bahamas,Trinidad and Tobago,0,0,World Cup qualifier,Bahamas,1,0
2354,6/5/2021,Panama,Anguilla,13,0,World Cup qualifier,Panama,1,13
2355,6/5/2021,Wales,Albania,0,0,Friendly,Wales,1,0
2356,6/5/2021,Sweden,Armenia,3,1,Friendly,Sweden,1,2
2357,6/5/2021,Russia,Bulgaria,1,0,Friendly,Russia,1,1
2358,6/5/2021,Montenegro,Israel,1,3,Friendly,Montenegro,1,-2
2359,6/6/2021,Algeria,Mali,1,0,Friendly,Algeria,1,1
2360,6/6/2021,United States,Mexico,3,2,CONCACAF Nations League,United States,1,1
2361,6/6/2021,Costa Rica,Honduras,2,2,CONCACAF Nations League,United States,0,0
2362,6/6/2021,Luxembourg,Scotland,0,1,Friendly,Luxembourg,1,-1
2363,6/6/2021,England,Romania,1,0,Friendly,England,1,1
2364,6/6/2021,Austria,Slovakia,0,0,Friendly,Austria,1,0
2365,6/6/2021,Belgium,Croatia,1,0,Friendly,Belgium,1,1
2366,6/6/2021,Netherlands,Georgia,3,0,Friendly,Netherlands,1,3
2367,6/6/2021,Greece,Norway,2,1,Friendly,Spain,0,1
2368,6/6/2021,Denmark,Bosnia and Herzegovina,2,0,Friendly,Denmark,1,2
2369,6/6/2021,Moldova,Azerbaijan,1,0,Friendly,Moldova,1,1
2370,6/7/2021,Japan,Tajikistan,4,1,World Cup and Asian Cup qual,Japan,1,3
2371,6/7/2021,China,Philippines,2,0,World Cup and Asian Cup qual,United Arab Emirates,0,2
2372,6/7/2021,Australia,Taiwan,5,1,World Cup and Asian Cup qual,Kuwait,0,4
2373,6/7/2021,Vietnam,Indonesia,4,0,World Cup and Asian Cup qual,United Arab Emirates,0,4
2374,6/7/2021,India,Bangladesh,2,0,World Cup and Asian Cup qual,Qatar,0,2
2375,6/7/2021,Bahrain,Iran,0,3,World Cup and Asian Cup qual,Bahrain,1,-3
2376,6/7/2021,Mongolia,Kyrgyzstan,1,0,World Cup and Asian Cup qual,Japan,0,1
2377,6/7/2021,Syria,Guam,3,0,World Cup and Asian Cup qual,United Arab Emirates,0,3
2378,6/7/2021,Uzbekistan,Singapore,5,0,World Cup and Asian Cup qual,Saudi Arabia,0,5
2379,6/7/2021,Iraq,Cambodia,4,1,World Cup and Asian Cup qual,Bahrain,0,3
2380,6/7/2021,United Arab Emirates,Thailand,3,1,World Cup and Asian Cup qual,United Arab Emirates,1,2
2381,6/7/2021,Jordan,Nepal,3,0,World Cup and Asian Cup qual,Kuwait,0,3
2382,6/7/2021,Qatar,Oman,1,0,World Cup and Asian Cup qual,Qatar,1,1
2383,6/7/2021,Rwanda,Central African Republic,5,0,Friendly,Rwanda,1,5
2384,6/7/2021,Jamaica,Serbia,1,1,Friendly,Japan,0,0
2385,6/7/2021,Germany,Latvia,7,1,Friendly,Germany,1,6
2386,6/7/2021,Ukraine,Cyprus,4,0,Friendly,Ukraine,1,4
2387,6/7/2021,Faroe Islands,Liechtenstein,5,1,Friendly,Faroe Islands,1,4
2388,6/7/2021,Andorra,Gibraltar,0,0,Friendly,Andorra,1,0
2389,6/8/2021,Benin,Zambia,2,2,Friendly,Benin,1,0
2390,6/8/2021,Cameroon,Nigeria,0,0,Friendly,Austria,0,0
2391,6/8/2021,Morocco,Ghana,1,0,Friendly,Morocco,1,1
2392,6/8/2021,Gambia,Togo,1,0,Friendly,Turkey,0,1
2393,6/8/2021,Senegal,Cape Verde,2,0,Friendly,Senegal,1,2
2394,6/8/2021,Guinea,Kosovo,2,1,Friendly,Turkey,0,1
2395,6/8/2021,Mozambique,Eswatini,1,1,Friendly tournament,Mozambique,1,0
2396,6/8/2021,Canada,Suriname,4,0,World Cup qualifier,United States,0,4
2397,6/8/2021,El Salvador,Antigua and Barbuda,3,0,World Cup qualifier,El Salvador,1,3
2398,6/8/2021,Curaçao,Guatemala,0,0,World Cup qualifier,Curaçao,1,0
2399,6/8/2021,Haiti,Nicaragua,1,0,World Cup qualifier,Haiti,1,1
2400,6/8/2021,Puerto Rico,Guyana,2,0,World Cup qualifier,Saint Kitts and Nevis,0,2
2401,6/8/2021,Trinidad and Tobago,Saint Kitts and Nevis,2,0,World Cup qualifier,Dominican Republic,0,2
2402,6/8/2021,Barbados,Dominica,1,1,World Cup qualifier,Dominican Republic,0,0
2403,6/8/2021,Cuba,St Vincent & Grenadines,1,0,World Cup qualifier,Grenada,0,1
2404,6/8/2021,Grenada,Montserrat,1,2,World Cup qualifier,Grenada,1,-1
2405,6/8/2021,Panama,Dominican Republic,3,0,World Cup qualifier,Panama,1,3
2406,6/8/2021,Bermuda,Cayman Islands,1,1,World Cup qualifier,United States,0,0
2407,6/8/2021,Venezuela,Uruguay,0,0,World Cup qualifier,Venezuela,1,0
2408,6/8/2021,Colombia,Argentina,2,2,World Cup qualifier,Colombia,1,0
2409,6/8/2021,Chile,Bolivia,1,1,World Cup qualifier,Chile,1,0
2410,6/8/2021,Paraguay,Brazil,0,2,World Cup qualifier,Paraguay,1,-2
2411,6/8/2021,Ecuador,Peru,1,2,World Cup qualifier,Ecuador,1,-1
2412,6/8/2021,Hungary,Ireland,0,0,Friendly,Hungary,1,0
2413,6/8/2021,France,Bulgaria,3,0,Friendly,France,1,3
2414,6/8/2021,Poland,Iceland,2,2,Friendly,Poland,1,0
2415,6/8/2021,Spain,Lithuania,4,0,Friendly,Spain,1,4
2416,6/8/2021,Czechia,Albania,3,1,Friendly,Czechia,1,2
2417,6/9/2021,Turkmenistan,Lebanon,3,2,World Cup and Asian Cup qual,South Korea,0,1
2418,6/9/2021,South Korea,Sri Lanka,5,0,World Cup and Asian Cup qual,South Korea,1,5
2419,6/9/2021,Congo,Niger,1,0,Friendly,Turkey,0,1
2420,6/9/2021,United States,Costa Rica,4,0,Friendly,United States,1,4
2421,6/9/2021,Portugal,Israel,4,0,Friendly,Portugal,1,4
2422,6/10/2021,South Africa,Uganda,3,2,Friendly,South Africa,1,1
2423,6/10/2021,Estonia,Latvia,2,1,Baltic Cup,Estonia,1,1
2424,6/11/2021,Japan,Serbia,1,0,Friendly,Japan,1,1
2425,6/11/2021,Philippines,Guam,3,0,World Cup and Asian Cup qual,United Arab Emirates,0,3
2426,6/11/2021,Australia,Nepal,3,0,World Cup and Asian Cup qual,Kuwait,0,3
2427,6/11/2021,China,Maldives,5,0,World Cup and Asian Cup qual,United Arab Emirates,0,5
2428,6/11/2021,United Arab Emirates,Indonesia,5,0,World Cup and Asian Cup qual,United Arab Emirates,1,5
2429,6/11/2021,Oman,Afghanistan,2,1,World Cup and Asian Cup qual,Qatar,0,1
2430,6/11/2021,Iran,Cambodia,10,0,World Cup and Asian Cup qual,Bahrain,0,10
2431,6/11/2021,Vietnam,Malaysia,2,1,World Cup and Asian Cup qual,United Arab Emirates,0,1
2432,6/11/2021,Kyrgyzstan,Myanmar,8,1,World Cup and Asian Cup qual,Japan,0,7
2433,6/11/2021,Iraq,Hong Kong,1,0,World Cup and Asian Cup qual,Bahrain,0,1
2434,6/11/2021,Saudi Arabia,Singapore,3,0,World Cup and Asian Cup qual,Saudi Arabia,1,3
2435,6/11/2021,Kuwait,Jordan,0,0,World Cup and Asian Cup qual,Kuwait,1,0
2436,6/11/2021,Uzbekistan,Yemen,1,0,World Cup and Asian Cup qual,Saudi Arabia,0,1
2437,6/11/2021,Sudan,Zambia,3,2,Friendly,Sudan,1,1
2438,6/11/2021,DR Congo,Mali,1,1,Friendly,Tunisia,0,0
2439,6/11/2021,Kosovo,Gambia,1,0,Friendly,Turkey,0,1
2440,6/11/2021,Tunisia,Algeria,0,2,Friendly,Tunisia,1,-2
2441,6/11/2021,Guinea,Niger,2,1,Friendly,Turkey,0,1
2442,6/11/2021,Mauritania,Liberia,1,0,Friendly,Tunisia,0,1
2443,6/11/2021,Italy,Turkey,3,0,European Championship,Italy,1,3
2444,6/12/2021,Ghana,Ivory Coast,0,0,Friendly,Ghana,1,0
2445,6/12/2021,Morocco,Burkina Faso,1,0,Friendly,Morocco,1,1
2446,6/12/2021,Haiti,Canada,0,1,World Cup qualifier,Haiti,1,-1
2447,6/12/2021,Saint Kitts and Nevis,El Salvador,0,4,World Cup qualifier,Saint Kitts and Nevis,1,-4
2448,6/12/2021,Honduras,Mexico,0,0,Friendly,United States,0,0
2449,6/12/2021,Panama,Curaçao,2,1,World Cup qualifier,Panama,1,1
2450,6/12/2021,Switzerland,Wales,1,1,European Championship,Azerbaijan,0,0
2451,6/12/2021,Russia,Belgium,0,3,European Championship,Russia,1,-3
2452,6/12/2021,Denmark,Finland,0,1,European Championship,Denmark,1,-1
2453,6/13/2021,South Korea,Lebanon,2,1,World Cup and Asian Cup qual,South Korea,1,1
2454,6/13/2021,Tanzania,Malawi,2,0,Friendly,Tanzania,1,2
2455,6/13/2021,Sudan,Zambia,0,1,Friendly,Sudan,1,-1
2456,6/13/2021,Brazil,Venezuela,3,0,Copa America,Brazil,1,3
2457,6/13/2021,Colombia,Ecuador,1,0,Copa America,Brazil,0,1
2458,6/13/2021,England,Croatia,1,0,European Championship,England,1,1
2459,6/13/2021,Austria,North Macedonia,3,1,European Championship,Romania,0,2
2460,6/13/2021,Netherlands,Ukraine,3,2,European Championship,Netherlands,1,1
2461,6/14/2021,Liberia,Libya,1,0,Friendly,Tunisia,0,1
2462,6/14/2021,Argentina,Chile,1,1,Copa America,Brazil,0,0
2463,6/14/2021,Paraguay,Bolivia,3,1,Copa America,Brazil,0,2
2464,6/14/2021,Scotland,Czechia,0,2,European Championship,Scotland,1,-2
2465,6/14/2021,Spain,Sweden,0,0,European Championship,Spain,1,0
2466,6/14/2021,Slovakia,Poland,2,1,European Championship,Russia,0,1
2467,6/15/2021,Japan,Kyrgyzstan,5,1,World Cup and Asian Cup qual,Japan,1,4
2468,6/15/2021,Maldives,Philippines,1,1,World Cup and Asian Cup qual,United Arab Emirates,0,0
2469,6/15/2021,Australia,Jordan,1,0,World Cup and Asian Cup qual,Kuwait,0,1
2470,6/15/2021,China,Syria,3,1,World Cup and Asian Cup qual,United Arab Emirates,0,2
2471,6/15/2021,Afghanistan,India,1,1,World Cup and Asian Cup qual,Qatar,0,0
2472,6/15/2021,Iran,Iraq,1,0,World Cup and Asian Cup qual,Bahrain,0,1
2473,6/15/2021,United Arab Emirates,Vietnam,3,2,World Cup and Asian Cup qual,United Arab Emirates,1,1
2474,6/15/2021,Kuwait,Taiwan,2,1,World Cup and Asian Cup qual,Kuwait,1,1
2475,6/15/2021,Tajikistan,Myanmar,4,0,World Cup and Asian Cup qual,Japan,0,4
2476,6/15/2021,Bahrain,Hong Kong,4,0,World Cup and Asian Cup qual,Bahrain,1,4
2477,6/15/2021,Malaysia,Thailand,1,0,World Cup and Asian Cup qual,United Arab Emirates,0,1
2478,6/15/2021,Saudi Arabia,Uzbekistan,3,0,World Cup and Asian Cup qual,Saudi Arabia,1,3
2479,6/15/2021,Palestine,Yemen,3,0,World Cup and Asian Cup qual,Saudi Arabia,0,3
2480,6/15/2021,Oman,Bangladesh,3,0,World Cup and Asian Cup qual,Qatar,0,3
2481,6/15/2021,Djibouti,Somalia,1,0,Friendly,Djibouti,1,1
2482,6/15/2021,Sierra Leone,Benin,1,0,African Nations Cup qualifier,Guinea,0,1
2483,6/15/2021,Tunisia,Mali,1,0,Friendly,Tunisia,1,1
2484,6/15/2021,Canada,Haiti,3,0,World Cup qualifier,United States,0,3
2485,6/15/2021,El Salvador,Saint Kitts and Nevis,2,0,World Cup qualifier,El Salvador,1,2
2486,6/15/2021,Curaçao,Panama,0,0,World Cup qualifier,Curaçao,1,0
2487,6/15/2021,Hungary,Portugal,0,3,European Championship,Hungary,1,-3
2488,6/15/2021,Germany,France,0,1,European Championship,Germany,1,-1
2489,6/16/2021,Wales,Turkey,2,0,European Championship,Azerbaijan,0,2
2490,6/16/2021,Italy,Switzerland,3,0,European Championship,Italy,1,3
2491,6/16/2021,Russia,Finland,1,0,European Championship,Russia,1,1
2492,6/17/2021,Algeria,Liberia,5,1,Friendly,Algeria,1,4
2493,6/17/2021,Brazil,Peru,4,0,Copa America,Brazil,1,4
2494,6/17/2021,Colombia,Venezuela,0,0,Copa America,Brazil,0,0
2495,6/17/2021,Netherlands,Austria,2,0,European Championship,Netherlands,1,2
2496,6/17/2021,Denmark,Belgium,1,2,European Championship,Denmark,1,-1
2497,6/17/2021,Ukraine,North Macedonia,2,1,European Championship,Romania,0,1
2498,6/18/2021,Argentina,Uruguay,1,0,Copa America,Brazil,0,1
2499,6/18/2021,Chile,Bolivia,1,0,Copa America,Brazil,0,1
2500,6/18/2021,England,Scotland,0,0,European Championship,England,1,0
2501,6/18/2021,Sweden,Slovakia,1,0,European Championship,Russia,0,1
2502,6/18/2021,Croatia,Czechia,1,1,European Championship,Scotland,0,0
2503,6/19/2021,Sudan,Libya,1,0,Arab Cup qualifier,Qatar,0,1
2504,6/19/2021,Hungary,France,1,1,European Championship,Hungary,1,0
2505,6/19/2021,Germany,Portugal,4,2,European Championship,Germany,1,2
2506,6/19/2021,Spain,Poland,1,1,European Championship,Spain,1,0
2507,6/20/2021,Oman,Somalia,2,1,Arab Cup qualifier,Qatar,0,1
2508,6/20/2021,Peru,Colombia,2,1,Copa America,Brazil,0,1
2509,6/20/2021,Ecuador,Venezuela,2,2,Copa America,Brazil,0,0
2510,6/20/2021,Italy,Wales,1,0,European Championship,Italy,1,1
2511,6/20/2021,Switzerland,Turkey,3,1,European Championship,Azerbaijan,0,2
2512,6/21/2021,Chile,Uruguay,1,1,Copa America,Brazil,0,0
2513,6/21/2021,Argentina,Paraguay,1,0,Copa America,Brazil,0,1
2514,6/21/2021,Austria,Ukraine,1,0,European Championship,Romania,0,1
2515,6/21/2021,Belgium,Finland,2,0,European Championship,Russia,0,2
2516,6/21/2021,Netherlands,North Macedonia,3,0,European Championship,Netherlands,1,3
2517,6/21/2021,Denmark,Russia,4,1,European Championship,Denmark,1,3
2518,6/22/2021,Mauritania,Yemen,2,0,Arab Cup qualifier,Qatar,0,2
2519,6/22/2021,Scotland,Croatia,1,3,European Championship,Scotland,1,-2
2520,6/22/2021,England,Czechia,1,0,European Championship,England,1,1
2521,6/23/2021,Lebanon,Djibouti,1,0,Arab Cup qualifier,Qatar,0,1
2522,6/23/2021,Martinique,Guadeloupe,1,2,Friendly,Martinique,1,-1
2523,6/23/2021,Brazil,Colombia,2,1,Copa America,Brazil,1,1
2524,6/23/2021,Ecuador,Peru,2,2,Copa America,Brazil,0,0
2525,6/23/2021,Germany,Hungary,2,2,European Championship,Germany,1,0
2526,6/23/2021,France,Portugal,2,2,European Championship,Hungary,0,0
2527,6/23/2021,Sweden,Poland,3,2,European Championship,Russia,0,1
2528,6/23/2021,Spain,Slovakia,5,0,European Championship,Spain,1,5
2529,6/24/2021,Palestine,Comoros,5,1,Arab Cup qualifier,Qatar,0,4
2530,6/24/2021,Uruguay,Bolivia,2,0,Copa America,Brazil,0,2
2531,6/24/2021,Paraguay,Chile,2,0,Copa America,Brazil,0,2
2532,6/25/2021,Bahrain,Kuwait,2,0,Arab Cup qualifier,Qatar,0,2
2533,6/26/2021,El Salvador,Guatemala,0,0,Friendly,United States,0,0
2534,6/26/2021,Denmark,Wales,4,0,European Championship,Netherlands,0,4
2535,6/26/2021,Italy,Austria,2,1,European Championship,England,0,1
2536,6/27/2021,Brazil,Ecuador,1,1,Copa America,Brazil,1,0
2537,6/27/2021,Peru,Venezuela,1,0,Copa America,Brazil,0,1
2538,6/27/2021,Belgium,Portugal,1,0,European Championship,Spain,0,1
2539,6/27/2021,Czechia,Netherlands,2,0,European Championship,Hungary,0,2
2540,6/28/2021,Guyana,Bermuda,1,0,Friendly,United States,0,1
2541,6/28/2021,Uruguay,Paraguay,1,0,Copa America,Brazil,0,1
2542,6/28/2021,Argentina,Bolivia,4,1,Copa America,Brazil,0,3
2543,6/28/2021,France,Switzerland,3,3,European Championship,Romania,0,0
2544,6/28/2021,Spain,Croatia,5,3,European Championship,Denmark,0,2
2545,6/29/2021,England,Germany,2,0,European Championship,England,1,2
2546,6/29/2021,Ukraine,Sweden,2,1,European Championship,Scotland,0,1
2547,6/30/2021,Mexico,Panama,3,0,Friendly,United States,0,3
2548,7/2/2021,Haiti,St Vincent & Grenadines,6,1,CONCACAF Champ qual,United States,0,5
2549,7/2/2021,Trinidad and Tobago,Montserrat,6,1,CONCACAF Champ qual,United States,0,5
2550,7/2/2021,Bermuda,Barbados,8,1,CONCACAF Champ qual,United States,0,7
2551,7/2/2021,Brazil,Chile,1,0,Copa America,Brazil,1,1
2552,7/2/2021,Paraguay,Peru,3,3,Copa America,Brazil,0,0
2553,7/2/2021,Italy,Belgium,2,1,European Championship,Germany,0,1
2554,7/2/2021,Spain,Switzerland,1,1,European Championship,Russia,0,0
2555,7/3/2021,Mexico,Nigeria,4,0,Friendly,United States,0,4
2556,7/3/2021,Lesotho,Namibia,0,0,Friendly,South Africa,0,0
2557,7/3/2021,Guatemala,Guyana,4,0,CONCACAF Champ qual,United States,0,4
2558,7/3/2021,Guadeloupe,Bahamas,2,0,CONCACAF Champ qual,United States,0,2
2559,7/3/2021,Colombia,Uruguay,0,0,Copa America,Brazil,0,0
2560,7/3/2021,Argentina,Ecuador,3,0,Copa America,Brazil,0,3
2561,7/3/2021,England,Ukraine,4,0,European Championship,Italy,0,4
2562,7/3/2021,Denmark,Czechia,2,1,European Championship,Azerbaijan,0,1
2563,7/4/2021,Qatar,El Salvador,1,0,Friendly,Croatia,0,1
2564,7/4/2021,Botswana,Namibia,1,1,Friendly,South Africa,0,0
2565,7/5/2021,Brazil,Peru,1,0,Copa America,Brazil,1,1
2566,7/6/2021,South Africa,Botswana,1,0,COSAFA Cup,South Africa,1,1
2567,7/6/2021,Eswatini,Lesotho,3,1,COSAFA Cup,South Africa,0,2
2568,7/6/2021,Guadeloupe,Guatemala,1,1,CONCACAF Champ qual,United States,0,0
2569,7/6/2021,Haiti,Bermuda,4,1,CONCACAF Champ qual,United States,0,3
2570,7/6/2021,French Guiana,Trinidad and Tobago,1,1,CONCACAF Champ qual,United States,0,0
2571,7/6/2021,Argentina,Colombia,1,1,Copa America,Brazil,0,0
2572,7/6/2021,Italy,Spain,1,1,European Championship,England,0,0
2573,7/7/2021,Mozambique,Zimbabwe,0,0,COSAFA Cup,South Africa,0,0
2574,7/7/2021,Namibia,Senegal,2,1,COSAFA Cup,South Africa,0,1
2575,7/7/2021,England,Denmark,2,1,European Championship,England,1,1
2576,7/8/2021,South Africa,Eswatini,1,0,COSAFA Cup,South Africa,1,1
2577,7/8/2021,Lesotho,Zambia,2,1,COSAFA Cup,South Africa,0,1
2578,7/9/2021,Malawi,Zimbabwe,2,2,COSAFA Cup,South Africa,0,0
2579,7/9/2021,Senegal,Mozambique,1,0,COSAFA Cup,South Africa,0,1
2580,7/9/2021,Colombia,Peru,3,2,Copa America,Brazil,0,1
2581,7/10/2021,Eswatini,Zambia,1,0,COSAFA Cup,South Africa,0,1
2582,7/10/2021,Botswana,Lesotho,4,0,COSAFA Cup,South Africa,0,4
2583,7/10/2021,Mexico,Trinidad and Tobago,0,0,CONCACAF Championship,United States,0,0
2584,7/10/2021,Brazil,Argentina,0,1,Copa America,Brazil,1,-1
2585,7/11/2021,Namibia,Zimbabwe,2,0,COSAFA Cup,South Africa,0,2
2586,7/11/2021,Mozambique,Malawi,2,0,COSAFA Cup,South Africa,0,2
2587,7/11/2021,United States,Haiti,1,0,CONCACAF Championship,United States,1,1
2588,7/11/2021,Canada,Martinique,4,1,CONCACAF Championship,United States,0,3
2589,7/11/2021,El Salvador,Guatemala,2,0,CONCACAF Championship,United States,0,2
2590,7/11/2021,England,Italy,1,1,European Championship,England,1,0
2591,7/12/2021,Costa Rica,Guadeloupe,3,1,CONCACAF Championship,United States,0,2
2592,7/12/2021,Jamaica,Suriname,2,0,CONCACAF Championship,United States,0,2
2593,7/13/2021,Panama,Qatar,3,3,CONCACAF Championship,United States,0,0
2594,7/13/2021,South Africa,Lesotho,4,0,COSAFA Cup,South Africa,1,4
2595,7/13/2021,Senegal,Zimbabwe,2,1,COSAFA Cup,South Africa,0,1
2596,7/13/2021,Zambia,Botswana,2,1,COSAFA Cup,South Africa,0,1
2597,7/13/2021,Malawi,Namibia,1,1,COSAFA Cup,South Africa,0,0
2598,7/13/2021,Honduras,Grenada,4,0,CONCACAF Championship,United States,0,4
2599,7/14/2021,South Africa,Zambia,0,0,COSAFA Cup,South Africa,1,0
2600,7/14/2021,Senegal,Malawi,2,1,COSAFA Cup,South Africa,0,1
2601,7/14/2021,Botswana,Eswatini,1,1,COSAFA Cup,South Africa,0,0
2602,7/14/2021,Mozambique,Namibia,1,0,COSAFA Cup,South Africa,0,1
2603,7/14/2021,El Salvador,Trinidad and Tobago,2,0,CONCACAF Championship,United States,0,2
2604,7/14/2021,Mexico,Guatemala,3,0,CONCACAF Championship,United States,0,3
2605,7/15/2021,United States,Martinique,6,1,CONCACAF Championship,United States,1,5
2606,7/15/2021,Canada,Haiti,4,1,CONCACAF Championship,United States,0,3
2607,7/16/2021,South Africa,Mozambique,3,0,COSAFA Cup,South Africa,1,3
2608,7/16/2021,Eswatini,Senegal,2,2,COSAFA Cup,South Africa,0,0
2609,7/16/2021,Costa Rica,Suriname,2,1,CONCACAF Championship,United States,0,1
2610,7/16/2021,Jamaica,Guadeloupe,2,1,CONCACAF Championship,United States,0,1
2611,7/17/2021,Qatar,Grenada,4,0,CONCACAF Championship,United States,0,4
2612,7/17/2021,Honduras,Panama,3,2,CONCACAF Championship,United States,0,1
2613,7/18/2021,South Africa,Senegal,0,0,COSAFA Cup,South Africa,1,0
2614,7/18/2021,Eswatini,Mozambique,1,1,COSAFA Cup,South Africa,0,0
2615,7/18/2021,United States,Canada,1,0,CONCACAF Championship,United States,1,1
2616,7/18/2021,Mexico,El Salvador,1,0,CONCACAF Championship,United States,0,1
2617,7/18/2021,Guatemala,Trinidad and Tobago,1,1,CONCACAF Championship,United States,0,0
2618,7/18/2021,Haiti,Martinique,2,1,CONCACAF Championship,United States,0,1
2619,7/20/2021,Qatar,Honduras,2,0,CONCACAF Championship,United States,0,2
2620,7/20/2021,Costa Rica,Jamaica,1,0,CONCACAF Championship,United States,0,1
2621,7/20/2021,Suriname,Guadeloupe,2,1,CONCACAF Championship,United States,0,1
2622,7/20/2021,Panama,Grenada,3,1,CONCACAF Championship,United States,0,2
2623,7/24/2021,Qatar,El Salvador,3,2,CONCACAF Championship,United States,0,1
2624,7/24/2021,Mexico,Honduras,3,0,CONCACAF Championship,United States,0,3
2625,7/25/2021,United States,Jamaica,1,0,CONCACAF Championship,United States,1,1
2626,7/25/2021,Canada,Costa Rica,2,0,CONCACAF Championship,United States,0,2
2627,7/29/2021,United States,Qatar,1,0,CONCACAF Championship,United States,1,1
2628,7/29/2021,Mexico,Canada,2,1,CONCACAF Championship,United States,0,1
2629,8/1/2021,United States,Mexico,1,0,CONCACAF Championship,United States,1,1
2630,8/19/2021,Togo,Benin,0,2,Friendly,Togo,1,-2
2631,8/21/2021,Costa Rica,El Salvador,0,0,Friendly,United States,0,0
2632,8/22/2021,Niger,Sudan,2,1,Friendly,United Arab Emirates,0,1
2633,8/26/2021,Algeria,Syria,2,1,Friendly,Qatar,0,1
2634,8/26/2021,Ethiopia,Sierra Leone,0,0,Friendly,Ethiopia,1,0
2635,8/26/2021,Sudan,Niger,3,0,Friendly,United Arab Emirates,0,3
2636,8/29/2021,Ethiopia,Uganda,2,1,Friendly,Ethiopia,1,1
2637,8/29/2021,Algeria,Burundi,3,0,Friendly,Qatar,0,3
2638,9/1/2021,Bahrain,Haiti,6,1,Friendly tournament,Bahrain,1,5
2639,9/1/2021,Serbia,Qatar,4,0,Friendly,Hungary,0,4
2640,9/1/2021,Egypt,Angola,1,0,World Cup qualifier,Egypt,1,1
2641,9/1/2021,Guinea-Bissau,Guinea,1,1,World Cup qualifier,Mauritania,0,0
2642,9/1/2021,Senegal,Togo,2,0,World Cup qualifier,Senegal,1,2
2643,9/1/2021,Libya,Gabon,2,1,World Cup qualifier,Libya,1,1
2644,9/1/2021,Cape Verde,Central African Republic,1,1,World Cup qualifier,Cameroon,0,0
2645,9/1/2021,Mali,Rwanda,1,0,World Cup qualifier,Morocco,0,1
2646,9/1/2021,Comoros,Seychelles,7,1,Friendly tournament,Comoros,1,6
2647,9/1/2021,Denmark,Scotland,2,0,World Cup qualifier,Denmark,1,2
2648,9/1/2021,Finland,Wales,0,0,Friendly,Finland,1,0
2649,9/1/2021,Moldova,Austria,0,2,World Cup qualifier,Moldova,1,-2
2650,9/1/2021,France,Bosnia and Herzegovina,1,1,World Cup qualifier,France,1,0
2651,9/1/2021,Switzerland,Greece,2,1,Friendly,Switzerland,1,1
2652,9/1/2021,Norway,Netherlands,1,1,World Cup qualifier,Norway,1,0
2653,9/1/2021,Luxembourg,Azerbaijan,2,1,World Cup qualifier,Luxembourg,1,1
2654,9/1/2021,Russia,Croatia,0,0,World Cup qualifier,Russia,1,0
2655,9/1/2021,Portugal,Ireland,2,1,World Cup qualifier,Portugal,1,1
2656,9/1/2021,Latvia,Gibraltar,3,1,World Cup qualifier,Latvia,1,2
2657,9/1/2021,Turkey,Montenegro,2,2,World Cup qualifier,Turkey,1,0
2658,9/1/2021,Kazakhstan,Ukraine,2,2,World Cup qualifier,Kazakhstan,1,0
2659,9/1/2021,Faroe Islands,Israel,0,4,World Cup qualifier,Faroe Islands,1,-4
2660,9/1/2021,Slovenia,Slovakia,1,1,World Cup qualifier,Slovenia,1,0
2661,9/1/2021,Malta,Cyprus,3,0,World Cup qualifier,Malta,1,3
2662,9/2/2021,Japan,Oman,0,1,World Cup qualifier,Japan,1,-1
2663,9/2/2021,Australia,China,3,0,World Cup qualifier,Qatar,0,3
2664,9/2/2021,Nepal,India,1,1,Friendly,Nepal,1,0
2665,9/2/2021,United Arab Emirates,Lebanon,0,0,World Cup qualifier,United Arab Emirates,1,0
2666,9/2/2021,Iran,Syria,1,0,World Cup qualifier,Iran,1,1
2667,9/2/2021,South Korea,Iraq,0,0,World Cup qualifier,South Korea,1,0
2668,9/2/2021,Saudi Arabia,Vietnam,3,1,World Cup qualifier,Saudi Arabia,1,2
2669,9/2/2021,Kyrgyzstan,Palestine,1,0,Friendly tournament,Kyrgyzstan,1,1
2670,9/2/2021,Kenya,Uganda,0,0,World Cup qualifier,Kenya,1,0
2671,9/2/2021,DR Congo,Tanzania,1,1,World Cup qualifier,DR Congo,1,0
2672,9/2/2021,Madagascar,Benin,0,1,World Cup qualifier,Madagascar,1,-1
2673,9/2/2021,Algeria,Djibouti,8,0,World Cup qualifier,Algeria,1,8
2674,9/2/2021,Morocco,Sudan,2,0,World Cup qualifier,Morocco,1,2
2675,9/2/2021,Burkina Faso,Niger,2,0,World Cup qualifier,Morocco,0,2
2676,9/2/2021,Congo,Namibia,1,1,World Cup qualifier,South Africa,0,0
2677,9/2/2021,El Salvador,United States,0,0,World Cup qualifier,El Salvador,1,0
2678,9/2/2021,Canada,Honduras,1,1,World Cup qualifier,Canada,1,0
2679,9/2/2021,Panama,Costa Rica,0,0,World Cup qualifier,Panama,1,0
2680,9/2/2021,Mexico,Jamaica,2,1,World Cup qualifier,Mexico,1,1
2681,9/2/2021,Peru,Uruguay,1,1,World Cup qualifier,Peru,1,0
2682,9/2/2021,Venezuela,Argentina,1,3,World Cup qualifier,Venezuela,1,-2
2683,9/2/2021,Chile,Brazil,0,1,World Cup qualifier,Chile,1,-1
2684,9/2/2021,Ecuador,Paraguay,2,0,World Cup qualifier,Ecuador,1,2
2685,9/2/2021,Bolivia,Colombia,1,1,World Cup qualifier,Bolivia,1,0
2686,9/2/2021,Hungary,England,0,4,World Cup qualifier,Hungary,1,-4
2687,9/2/2021,Lithuania,Northern Ireland,1,4,World Cup qualifier,Lithuania,1,-3
2688,9/2/2021,Estonia,Belgium,2,5,World Cup qualifier,Estonia,1,-3
2689,9/2/2021,Germany,Liechtenstein,2,0,World Cup qualifier,Switzerland,0,2
2690,9/2/2021,Sweden,Spain,2,1,World Cup qualifier,Sweden,1,1
2691,9/2/2021,Italy,Bulgaria,1,1,World Cup qualifier,Italy,1,0
2692,9/2/2021,Poland,Albania,4,1,World Cup qualifier,Poland,1,3
2693,9/2/2021,Iceland,Romania,0,2,World Cup qualifier,Iceland,1,-2
2694,9/2/2021,Czechia,Belarus,1,0,World Cup qualifier,Czechia,1,1
2695,9/2/2021,North Macedonia,Armenia,0,0,World Cup qualifier,North Macedonia,1,0
2696,9/2/2021,Georgia,Kosovo,0,1,World Cup qualifier,Georgia,1,-1
2697,9/2/2021,Andorra,San Marino,2,0,World Cup qualifier,Andorra,1,2
2698,9/3/2021,Zimbabwe,South Africa,0,0,World Cup qualifier,Zimbabwe,1,0
2699,9/3/2021,Mauritania,Zambia,1,2,World Cup qualifier,Mauritania,1,-1
2700,9/3/2021,Ghana,Ethiopia,1,0,World Cup qualifier,Ghana,1,1
2701,9/3/2021,Nigeria,Liberia,2,0,World Cup qualifier,Nigeria,1,2
2702,9/3/2021,Tunisia,Equatorial Guinea,3,0,World Cup qualifier,Tunisia,1,3
2703,9/3/2021,Cameroon,Malawi,2,0,World Cup qualifier,Cameroon,1,2
2704,9/3/2021,Mozambique,Ivory Coast,0,0,World Cup qualifier,Mozambique,1,0
2705,9/4/2021,Bosnia and Herzegovina,Kuwait,1,0,Friendly,Bosnia and Herzegovina,1,1
2706,9/4/2021,Haiti,Jordan,2,0,Friendly tournament,Bahrain,0,2
2707,9/4/2021,Portugal,Qatar,3,1,Friendly,Hungary,0,2
2708,9/4/2021,Burundi,Seychelles,8,1,Friendly tournament,Comoros,0,7
2709,9/4/2021,Scotland,Moldova,1,0,World Cup qualifier,Scotland,1,1
2710,9/4/2021,Israel,Austria,5,2,World Cup qualifier,Israel,1,3
2711,9/4/2021,Ukraine,France,1,1,World Cup qualifier,Ukraine,1,0
2712,9/4/2021,Netherlands,Montenegro,4,0,World Cup qualifier,Netherlands,1,4
2713,9/4/2021,Latvia,Norway,0,2,World Cup qualifier,Latvia,1,-2
2714,9/4/2021,Finland,Kazakhstan,1,0,World Cup qualifier,Finland,1,1
2715,9/4/2021,Serbia,Luxembourg,4,1,World Cup qualifier,Serbia,1,3
2716,9/4/2021,Cyprus,Russia,0,2,World Cup qualifier,Cyprus,1,-2
2717,9/4/2021,Faroe Islands,Denmark,0,1,World Cup qualifier,Faroe Islands,1,-1
2718,9/4/2021,Gibraltar,Turkey,0,3,World Cup qualifier,Gibraltar,1,-3
2719,9/4/2021,Ireland,Azerbaijan,1,1,World Cup qualifier,Ireland,1,0
2720,9/4/2021,Slovakia,Croatia,0,1,World Cup qualifier,Slovakia,1,-1
2721,9/4/2021,Slovenia,Malta,1,0,World Cup qualifier,Slovenia,1,1
2722,9/5/2021,Nepal,India,1,2,Friendly,Nepal,1,-1
2723,9/5/2021,Palestine,Bangladesh,2,0,Friendly tournament,Kyrgyzstan,0,2
2724,9/5/2021,Sweden,Uzbekistan,2,1,Friendly,Sweden,1,1
2725,9/5/2021,Gabon,Egypt,1,1,World Cup qualifier,Gabon,1,0
2726,9/5/2021,Rwanda,Kenya,1,1,World Cup qualifier,Rwanda,1,0
2727,9/5/2021,Togo,Namibia,0,1,World Cup qualifier,Togo,1,-1
2728,9/5/2021,United States,Canada,1,1,World Cup qualifier,United States,1,0
2729,9/5/2021,Costa Rica,Mexico,0,1,World Cup qualifier,Costa Rica,1,-1
2730,9/5/2021,El Salvador,Honduras,0,0,World Cup qualifier,El Salvador,1,0
2731,9/5/2021,Jamaica,Panama,0,3,World Cup qualifier,Jamaica,1,-3
2732,9/5/2021,Uruguay,Bolivia,4,2,World Cup qualifier,Uruguay,1,2
2733,9/5/2021,Ecuador,Chile,0,0,World Cup qualifier,Ecuador,1,0
2734,9/5/2021,Paraguay,Colombia,1,1,World Cup qualifier,Paraguay,1,0
2735,9/5/2021,Peru,Venezuela,1,0,World Cup qualifier,Peru,1,1
2736,9/5/2021,England,Andorra,4,0,World Cup qualifier,England,1,4
2737,9/5/2021,Wales,Belarus,3,2,World Cup qualifier,Russia,0,1
2738,9/5/2021,Estonia,Northern Ireland,0,1,Friendly,Estonia,1,-1
2739,9/5/2021,Albania,Hungary,1,0,World Cup qualifier,Albania,1,1
2740,9/5/2021,Belgium,Czechia,3,0,World Cup qualifier,Belgium,1,3
2741,9/5/2021,Switzerland,Italy,0,0,World Cup qualifier,Switzerland,1,0
2742,9/5/2021,Germany,Armenia,6,0,World Cup qualifier,Germany,1,6
2743,9/5/2021,San Marino,Poland,1,7,World Cup qualifier,San Marino,1,-6
2744,9/5/2021,Spain,Georgia,4,0,World Cup qualifier,Spain,1,4
2745,9/5/2021,Romania,Liechtenstein,2,0,World Cup qualifier,Romania,1,2
2746,9/5/2021,Bulgaria,Lithuania,1,0,World Cup qualifier,Bulgaria,1,1
2747,9/5/2021,Kosovo,Greece,1,1,World Cup qualifier,Kosovo,1,0
2748,9/5/2021,Iceland,North Macedonia,2,2,World Cup qualifier,Iceland,1,0
2749,9/6/2021,South Africa,Ghana,1,0,World Cup qualifier,South Africa,1,1
2750,9/6/2021,Uganda,Mali,0,0,World Cup qualifier,Uganda,1,0
2751,9/6/2021,Niger,Djibouti,4,2,World Cup qualifier,Morocco,0,2
2752,9/6/2021,Benin,DR Congo,1,1,World Cup qualifier,Benin,1,0
2753,9/6/2021,Ivory Coast,Cameroon,2,1,World Cup qualifier,Ivory Coast,1,1
2754,9/6/2021,Liberia,Central African Republic,1,0,World Cup qualifier,Cameroon,0,1
2755,9/7/2021,Japan,China,1,0,World Cup qualifier,Qatar,0,1
2756,9/7/2021,Vietnam,Australia,0,1,World Cup qualifier,Vietnam,1,-1
2757,9/7/2021,South Korea,Lebanon,1,0,World Cup qualifier,South Korea,1,1
2758,9/7/2021,Iran,Iraq,3,0,World Cup qualifier,Qatar,0,3
2759,9/7/2021,Syria,United Arab Emirates,1,1,World Cup qualifier,Jordan,0,0
2760,9/7/2021,Kyrgyzstan,Bangladesh,4,1,Friendly tournament,Kyrgyzstan,1,3
2761,9/7/2021,Bahrain,Jordan,1,2,Friendly tournament,Bahrain,1,-1
2762,9/7/2021,Oman,Saudi Arabia,0,1,World Cup qualifier,Oman,1,-1
2763,9/7/2021,Luxembourg,Qatar,1,1,Friendly,Luxembourg,1,0
2764,9/7/2021,Tanzania,Madagascar,3,2,World Cup qualifier,Tanzania,1,1
2765,9/7/2021,Ethiopia,Zimbabwe,1,0,World Cup qualifier,Ethiopia,1,1
2766,9/7/2021,Zambia,Tunisia,0,2,World Cup qualifier,Zambia,1,-2
2767,9/7/2021,Cape Verde,Nigeria,1,2,World Cup qualifier,Cape Verde,1,-1
2768,9/7/2021,Sudan,Guinea-Bissau,2,4,World Cup qualifier,Sudan,1,-2
2769,9/7/2021,Comoros,Burundi,1,0,Friendly tournament,Comoros,1,1
2770,9/7/2021,Angola,Libya,0,1,World Cup qualifier,Angola,1,-1
2771,9/7/2021,Malawi,Mozambique,1,0,World Cup qualifier,South Africa,0,1
2772,9/7/2021,Burkina Faso,Algeria,1,1,World Cup qualifier,Morocco,0,0
2773,9/7/2021,Congo,Senegal,1,3,World Cup qualifier,Congo,1,-2
2774,9/7/2021,Equatorial Guinea,Mauritania,1,0,World Cup qualifier,Equatorial Guinea,1,1
2775,9/7/2021,Austria,Scotland,0,1,World Cup qualifier,Austria,1,-1
2776,9/7/2021,France,Finland,2,0,World Cup qualifier,France,1,2
2777,9/7/2021,Netherlands,Turkey,6,1,World Cup qualifier,Netherlands,1,5
2778,9/7/2021,Norway,Gibraltar,5,1,World Cup qualifier,Norway,1,4
2779,9/7/2021,Russia,Malta,2,0,World Cup qualifier,Russia,1,2
2780,9/7/2021,Denmark,Israel,5,0,World Cup qualifier,Denmark,1,5
2781,9/7/2021,Azerbaijan,Portugal,0,3,World Cup qualifier,Azerbaijan,1,-3
2782,9/7/2021,Montenegro,Latvia,0,0,World Cup qualifier,Montenegro,1,0
2783,9/7/2021,Ireland,Serbia,1,1,World Cup qualifier,Ireland,1,0
2784,9/7/2021,Slovakia,Cyprus,2,0,World Cup qualifier,Slovakia,1,2
2785,9/7/2021,Croatia,Slovenia,3,0,World Cup qualifier,Croatia,1,3
2786,9/7/2021,Faroe Islands,Moldova,2,1,World Cup qualifier,Faroe Islands,1,1
2787,9/7/2021,Bosnia and Herzegovina,Kazakhstan,2,2,World Cup qualifier,Bosnia and Herzegovina,1,0
2788,9/8/2021,Honduras,United States,1,4,World Cup qualifier,Honduras,1,-3
2789,9/8/2021,Canada,El Salvador,3,0,World Cup qualifier,Canada,1,3
2790,9/8/2021,Costa Rica,Jamaica,1,1,World Cup qualifier,Costa Rica,1,0
2791,9/8/2021,Guatemala,Nicaragua,2,2,Friendly,Guatemala,1,0
2792,9/8/2021,Panama,Mexico,1,1,World Cup qualifier,Panama,1,0
2793,9/8/2021,Poland,England,1,1,World Cup qualifier,Poland,1,0
2794,9/8/2021,Wales,Estonia,0,0,World Cup qualifier,Wales,1,0
2795,9/8/2021,Northern Ireland,Switzerland,0,0,World Cup qualifier,Northern Ireland,1,0
2796,9/8/2021,Hungary,Andorra,2,1,World Cup qualifier,Hungary,1,1
2797,9/8/2021,Belarus,Belgium,0,1,World Cup qualifier,Russia,0,-1
2798,9/8/2021,Iceland,Germany,0,4,World Cup qualifier,Iceland,1,-4
2799,9/8/2021,Greece,Sweden,2,1,World Cup qualifier,Greece,1,1
2800,9/8/2021,Italy,Lithuania,5,0,World Cup qualifier,Italy,1,5
2801,9/8/2021,Kosovo,Spain,0,2,World Cup qualifier,Kosovo,1,-2
2802,9/8/2021,North Macedonia,Romania,0,0,World Cup qualifier,North Macedonia,1,0
2803,9/8/2021,Bulgaria,Georgia,4,1,Friendly,Bulgaria,1,3
2804,9/8/2021,Czechia,Ukraine,1,1,Friendly,Czechia,1,0
2805,9/8/2021,Albania,San Marino,5,0,World Cup qualifier,Albania,1,5
2806,9/8/2021,Armenia,Liechtenstein,1,1,World Cup qualifier,Armenia,1,0
2807,9/9/2021,Uruguay,Ecuador,1,0,World Cup qualifier,Uruguay,1,1
2808,9/9/2021,Argentina,Bolivia,3,0,World Cup qualifier,Argentina,1,3
2809,9/9/2021,Colombia,Chile,3,1,World Cup qualifier,Colombia,1,2
2810,9/9/2021,Brazil,Peru,2,0,World Cup qualifier,Brazil,1,2
2811,9/9/2021,Paraguay,Venezuela,2,1,World Cup qualifier,Paraguay,1,1
2812,9/24/2021,Guatemala,El Salvador,2,0,Friendly,United States,0,2
2813,9/26/2021,Oman,Nepal,7,2,Friendly,Qatar,0,5
2814,9/30/2021,Egypt,Liberia,2,0,Friendly,Egypt,1,2
2815,10/1/2021,Bangladesh,Sri Lanka,1,0,South Asian Championship,Maldives,0,1
2816,10/1/2021,Maldives,Nepal,0,1,South Asian Championship,Maldives,1,-1
2817,10/1/2021,Curaçao,Aruba,7,1,Friendly tournament,Curaçao,1,6
2818,10/3/2021,Curaçao,Bonaire,1,0,Friendly tournament,Curaçao,1,1
2819,10/4/2021,Bangladesh,India,1,1,South Asian Championship,Maldives,0,0
2820,10/4/2021,Nepal,Sri Lanka,3,2,South Asian Championship,Maldives,0,1
2821,10/6/2021,Jordan,Malaysia,4,0,Friendly tournament,Jordan,1,4
2822,10/6/2021,Bahrain,Curaçao,4,0,Friendly tournament,Bahrain,1,4
2823,10/6/2021,Sierra Leone,South Sudan,1,1,Friendly tournament,Morocco,0,0
2824,10/6/2021,Morocco,Guinea-Bissau,5,0,World Cup qualifier,Morocco,1,5
2825,10/6/2021,Guinea,Sudan,1,1,World Cup qualifier,Morocco,0,0
2826,10/6/2021,Italy,Spain,1,2,European Nations League,Italy,1,-1
2827,10/7/2021,Saudi Arabia,Japan,1,0,World Cup qualifier,Saudi Arabia,1,1
2828,10/7/2021,Australia,Oman,3,1,World Cup qualifier,Qatar,0,2
2829,10/7/2021,China,Vietnam,3,2,World Cup qualifier,United Arab Emirates,0,1
2830,10/7/2021,Indonesia,Taiwan,2,1,Asian Cup qualifier,Thailand,0,1
2831,10/7/2021,India,Sri Lanka,0,0,South Asian Championship,Maldives,0,0
2832,10/7/2021,Iraq,Lebanon,0,0,World Cup qualifier,Qatar,0,0
2833,10/7/2021,United Arab Emirates,Iran,0,1,World Cup qualifier,United Arab Emirates,1,-1
2834,10/7/2021,South Korea,Syria,2,1,World Cup qualifier,South Korea,1,1
2835,10/7/2021,Maldives,Bangladesh,2,0,South Asian Championship,Maldives,1,2
2836,10/7/2021,Mali,Kenya,5,0,World Cup qualifier,Morocco,0,5
2837,10/7/2021,Rwanda,Uganda,0,1,World Cup qualifier,Rwanda,1,-1
2838,10/7/2021,Tanzania,Benin,0,1,World Cup qualifier,Tanzania,1,-1
2839,10/7/2021,Equatorial Guinea,Zambia,2,0,World Cup qualifier,Equatorial Guinea,1,2
2840,10/7/2021,DR Congo,Madagascar,2,0,World Cup qualifier,DR Congo,1,2
2841,10/7/2021,Nigeria,Central African Republic,0,1,World Cup qualifier,Nigeria,1,-1
2842,10/7/2021,Tunisia,Mauritania,3,0,World Cup qualifier,Tunisia,1,3
2843,10/7/2021,Cape Verde,Liberia,2,1,World Cup qualifier,Ghana,0,1
2844,10/7/2021,United States,Jamaica,2,0,World Cup qualifier,United States,1,2
2845,10/7/2021,Mexico,Canada,1,1,World Cup qualifier,Mexico,1,0
2846,10/7/2021,Honduras,Costa Rica,0,0,World Cup qualifier,Honduras,1,0
2847,10/7/2021,El Salvador,Panama,1,0,World Cup qualifier,El Salvador,1,1
2848,10/7/2021,Uruguay,Colombia,0,0,World Cup qualifier,Uruguay,1,0
2849,10/7/2021,Paraguay,Argentina,0,0,World Cup qualifier,Paraguay,1,0
2850,10/7/2021,Peru,Chile,2,0,World Cup qualifier,Peru,1,2
2851,10/7/2021,Venezuela,Brazil,1,3,World Cup qualifier,Venezuela,1,-2
2852,10/7/2021,Ecuador,Bolivia,3,0,World Cup qualifier,Ecuador,1,3
2853,10/7/2021,France,Belgium,3,2,European Nations League,Italy,0,1
2854,10/8/2021,Egypt,Libya,1,0,World Cup qualifier,Egypt,1,1
2855,10/8/2021,Burkina Faso,Djibouti,4,0,World Cup qualifier,Morocco,0,4
2856,10/8/2021,Ivory Coast,Malawi,3,0,World Cup qualifier,South Africa,0,3
2857,10/8/2021,Cameroon,Mozambique,3,1,World Cup qualifier,Cameroon,1,2
2858,10/8/2021,Angola,Gabon,3,1,World Cup qualifier,Angola,1,2
2859,10/8/2021,Algeria,Niger,6,1,World Cup qualifier,Algeria,1,5
2860,10/8/2021,Czechia,Wales,2,2,World Cup qualifier,Czechia,1,0
2861,10/8/2021,Latvia,Netherlands,0,1,World Cup qualifier,Latvia,1,-1
2862,10/8/2021,Germany,Romania,2,1,World Cup qualifier,Germany,1,1
2863,10/8/2021,Turkey,Norway,1,1,World Cup qualifier,Turkey,1,0
2864,10/8/2021,Russia,Slovakia,1,0,World Cup qualifier,Russia,1,1
2865,10/8/2021,Estonia,Belarus,2,0,World Cup qualifier,Estonia,1,2
2866,10/8/2021,Cyprus,Croatia,0,3,World Cup qualifier,Cyprus,1,-3
2867,10/8/2021,Iceland,Armenia,1,1,World Cup qualifier,Iceland,1,0
2868,10/8/2021,Gibraltar,Montenegro,0,3,World Cup qualifier,Gibraltar,1,-3
2869,10/8/2021,Malta,Slovenia,0,4,World Cup qualifier,Malta,1,-4
2870,10/8/2021,Liechtenstein,North Macedonia,0,4,World Cup qualifier,Liechtenstein,1,-4
2871,10/9/2021,Uzbekistan,Malaysia,5,1,Friendly tournament,Jordan,0,4
2872,10/9/2021,Cambodia,Guam,1,0,Asian Cup qualifier,Bahrain,0,1
2873,10/9/2021,Portugal,Qatar,3,0,Friendly,Portugal,1,3
2874,10/9/2021,Ethiopia,South Africa,1,3,World Cup qualifier,Ethiopia,1,-2
2875,10/9/2021,Ghana,Zimbabwe,3,1,World Cup qualifier,Ghana,1,2
2876,10/9/2021,Sierra Leone,Gambia,2,1,Friendly tournament,Morocco,0,1
2877,10/9/2021,Morocco,Guinea-Bissau,3,0,World Cup qualifier,Morocco,1,3
2878,10/9/2021,Togo,Congo,1,1,World Cup qualifier,Togo,1,0
2879,10/9/2021,Guinea,Sudan,2,2,World Cup qualifier,Morocco,0,0
2880,10/9/2021,Senegal,Namibia,4,1,World Cup qualifier,Senegal,1,3
2881,10/9/2021,New Zealand,Curaçao,2,1,Friendly tournament,Bahrain,0,1
2882,10/9/2021,Scotland,Israel,3,2,World Cup qualifier,Scotland,1,1
2883,10/9/2021,Andorra,England,0,5,World Cup qualifier,Andorra,1,-5
2884,10/9/2021,Switzerland,Northern Ireland,2,0,World Cup qualifier,Switzerland,1,2
2885,10/9/2021,Faroe Islands,Austria,0,2,World Cup qualifier,Faroe Islands,1,-2
2886,10/9/2021,Hungary,Albania,0,1,World Cup qualifier,Hungary,1,-1
2887,10/9/2021,Sweden,Kosovo,3,0,World Cup qualifier,Sweden,1,3
2888,10/9/2021,Finland,Ukraine,1,2,World Cup qualifier,Finland,1,-1
2889,10/9/2021,Luxembourg,Serbia,0,1,World Cup qualifier,Luxembourg,1,-1
2890,10/9/2021,Moldova,Denmark,0,4,World Cup qualifier,Moldova,1,-4
2891,10/9/2021,Poland,San Marino,5,0,World Cup qualifier,Poland,1,5
2892,10/9/2021,Lithuania,Bulgaria,3,1,World Cup qualifier,Lithuania,1,2
2893,10/9/2021,Azerbaijan,Ireland,0,3,World Cup qualifier,Azerbaijan,1,-3
2894,10/9/2021,Georgia,Greece,0,2,World Cup qualifier,Georgia,1,-2
2895,10/9/2021,Kazakhstan,Bosnia and Herzegovina,0,2,World Cup qualifier,Kazakhstan,1,-2
2896,10/10/2021,India,Nepal,1,0,South Asian Championship,Maldives,0,1
2897,10/10/2021,Maldives,Sri Lanka,1,0,South Asian Championship,Maldives,1,1
2898,10/10/2021,Kenya,Mali,0,1,World Cup qualifier,Kenya,1,-1
2899,10/10/2021,Uganda,Rwanda,1,0,World Cup qualifier,Uganda,1,1
2900,10/10/2021,Benin,Tanzania,0,1,World Cup qualifier,Benin,1,-1
2901,10/10/2021,Zambia,Equatorial Guinea,1,1,World Cup qualifier,Zambia,1,0
2902,10/10/2021,Madagascar,DR Congo,1,0,World Cup qualifier,Madagascar,1,1
2903,10/10/2021,Nigeria,Central African Republic,2,0,World Cup qualifier,Cameroon,0,2
2904,10/10/2021,Mauritania,Tunisia,0,0,World Cup qualifier,Mauritania,1,0
2905,10/10/2021,Cape Verde,Liberia,1,0,World Cup qualifier,Cape Verde,1,1
2906,10/10/2021,Panama,United States,1,0,World Cup qualifier,Panama,1,1
2907,10/10/2021,Jamaica,Canada,0,0,World Cup qualifier,Jamaica,1,0
2908,10/10/2021,Costa Rica,El Salvador,2,1,World Cup qualifier,Costa Rica,1,1
2909,10/10/2021,Mexico,Honduras,3,0,World Cup qualifier,Mexico,1,3
2910,10/10/2021,Argentina,Uruguay,3,0,World Cup qualifier,Argentina,1,3
2911,10/10/2021,Chile,Paraguay,2,0,World Cup qualifier,Chile,1,2
2912,10/10/2021,Colombia,Brazil,0,0,World Cup qualifier,Colombia,1,0
2913,10/10/2021,Bolivia,Peru,1,0,World Cup qualifier,Bolivia,1,1
2914,10/10/2021,Venezuela,Ecuador,2,1,World Cup qualifier,Venezuela,1,1
2915,10/10/2021,Italy,Belgium,2,1,European Nations League,Italy,1,1
2916,10/10/2021,France,Spain,2,1,European Nations League,Italy,0,1
2917,10/11/2021,Indonesia,Taiwan,3,0,Asian Cup qualifier,Thailand,0,3
2918,10/11/2021,Libya,Egypt,0,3,World Cup qualifier,Libya,1,-3
2919,10/11/2021,Burkina Faso,Djibouti,2,0,World Cup qualifier,Morocco,0,2
2920,10/11/2021,Ivory Coast,Malawi,2,1,World Cup qualifier,Benin,0,1
2921,10/11/2021,Cameroon,Mozambique,1,0,World Cup qualifier,Morocco,0,1
2922,10/11/2021,Gabon,Angola,2,0,World Cup qualifier,Gabon,1,2
2923,10/11/2021,Estonia,Wales,0,1,World Cup qualifier,Estonia,1,-1
2924,10/11/2021,Netherlands,Gibraltar,6,0,World Cup qualifier,Netherlands,1,6
2925,10/11/2021,North Macedonia,Germany,0,4,World Cup qualifier,North Macedonia,1,-4
2926,10/11/2021,Norway,Montenegro,2,0,World Cup qualifier,Norway,1,2
2927,10/11/2021,Slovenia,Russia,1,2,World Cup qualifier,Slovenia,1,-1
2928,10/11/2021,Romania,Armenia,1,0,World Cup qualifier,Romania,1,1
2929,10/11/2021,Latvia,Turkey,1,2,World Cup qualifier,Latvia,1,-1
2930,10/11/2021,Czechia,Belarus,2,0,World Cup qualifier,Russia,0,2
2931,10/11/2021,Croatia,Slovakia,2,2,World Cup qualifier,Croatia,1,0
2932,10/11/2021,Iceland,Liechtenstein,4,0,World Cup qualifier,Iceland,1,4
2933,10/11/2021,Cyprus,Malta,2,2,World Cup qualifier,Cyprus,1,0
2934,10/12/2021,Japan,Australia,2,1,World Cup qualifier,Japan,1,1
2935,10/12/2021,Saudi Arabia,China,3,2,World Cup qualifier,Saudi Arabia,1,1
2936,10/12/2021,Lebanon,Syria,3,2,World Cup qualifier,Jordan,0,1
2937,10/12/2021,Iran,South Korea,1,1,World Cup qualifier,Iran,1,0
2938,10/12/2021,Oman,Vietnam,3,1,World Cup qualifier,Oman,1,2
2939,10/12/2021,Cambodia,Guam,2,1,Asian Cup qualifier,Bahrain,0,1
2940,10/12/2021,United Arab Emirates,Iraq,2,2,World Cup qualifier,United Arab Emirates,1,0
2941,10/12/2021,Jordan,Uzbekistan,3,0,Friendly tournament,Jordan,1,3
2942,10/12/2021,Bahrain,New Zealand,0,1,Friendly tournament,Bahrain,1,-1
2943,10/12/2021,Ireland,Qatar,4,0,Friendly,Ireland,1,4
2944,10/12/2021,South Africa,Ethiopia,1,0,World Cup qualifier,South Africa,1,1
2945,10/12/2021,Zimbabwe,Ghana,0,1,World Cup qualifier,Zimbabwe,1,-1
2946,10/12/2021,Gambia,South Sudan,2,1,Friendly tournament,Morocco,0,1
2947,10/12/2021,Congo,Togo,1,2,World Cup qualifier,Congo,1,-1
2948,10/12/2021,Morocco,Guinea,4,1,World Cup qualifier,Morocco,1,3
2949,10/12/2021,Senegal,Namibia,3,1,World Cup qualifier,South Africa,0,2
2950,10/12/2021,Niger,Algeria,0,4,World Cup qualifier,Niger,1,-4
2951,10/12/2021,Faroe Islands,Scotland,0,1,World Cup qualifier,Faroe Islands,1,-1
2952,10/12/2021,England,Hungary,1,1,World Cup qualifier,England,1,0
2953,10/12/2021,Bulgaria,Northern Ireland,2,1,World Cup qualifier,Bulgaria,1,1
2954,10/12/2021,Denmark,Austria,1,0,World Cup qualifier,Denmark,1,1
2955,10/12/2021,Lithuania,Switzerland,0,4,World Cup qualifier,Lithuania,1,-4
2956,10/12/2021,Sweden,Greece,2,0,World Cup qualifier,Sweden,1,2
2957,10/12/2021,Kazakhstan,Finland,0,2,World Cup qualifier,Kazakhstan,1,-2
2958,10/12/2021,Portugal,Luxembourg,5,0,World Cup qualifier,Portugal,1,5
2959,10/12/2021,Albania,Poland,0,1,World Cup qualifier,Albania,1,-1
2960,10/12/2021,Ukraine,Bosnia and Herzegovina,1,1,World Cup qualifier,Ukraine,1,0
2961,10/12/2021,Israel,Moldova,2,1,World Cup qualifier,Israel,1,1
2962,10/12/2021,Serbia,Azerbaijan,3,1,World Cup qualifier,Serbia,1,2
2963,10/12/2021,Kosovo,Georgia,1,2,World Cup qualifier,Kosovo,1,-1
2964,10/12/2021,San Marino,Andorra,0,3,World Cup qualifier,San Marino,1,-3
2965,10/13/2021,Maldives,India,1,3,South Asian Championship,Maldives,1,-2
2966,10/13/2021,Bangladesh,Nepal,1,1,South Asian Championship,Maldives,0,0
2967,10/13/2021,United States,Costa Rica,2,1,World Cup qualifier,United States,1,1
2968,10/13/2021,Canada,Panama,4,1,World Cup qualifier,Canada,1,3
2969,10/13/2021,El Salvador,Mexico,0,2,World Cup qualifier,El Salvador,1,-2
2970,10/13/2021,Honduras,Jamaica,0,2,World Cup qualifier,Honduras,1,-2
2971,10/14/2021,Brazil,Uruguay,4,1,World Cup qualifier,Brazil,1,3
2972,10/14/2021,Argentina,Peru,1,0,World Cup qualifier,Argentina,1,1
2973,10/14/2021,Chile,Venezuela,3,0,World Cup qualifier,Chile,1,3
2974,10/14/2021,Bolivia,Paraguay,4,0,World Cup qualifier,Bolivia,1,4
2975,10/14/2021,Colombia,Ecuador,0,0,World Cup qualifier,Colombia,1,0
2976,10/16/2021,India,Nepal,3,0,South Asian Championship,Maldives,0,3
2977,10/27/2021,Ecuador,Mexico,3,2,Friendly,United States,0,1
2978,11/5/2021,Bolivia,El Salvador,1,0,Friendly,United States,0,1
2979,11/9/2021,Sri Lanka,Maldives,4,4,Friendly tournament,Sri Lanka,1,0
2980,11/10/2021,Kosovo,Jordan,0,2,Friendly,Kosovo,1,-2
2981,11/10/2021,Bangladesh,Seychelles,1,1,Friendly tournament,Sri Lanka,0,0
2982,11/10/2021,Nicaragua,Cuba,0,3,Friendly,Nicaragua,1,-3
2983,11/11/2021,Vietnam,Japan,0,1,World Cup qualifier,Vietnam,1,-1
2984,11/11/2021,Australia,Saudi Arabia,0,0,World Cup qualifier,Australia,1,0
2985,11/11/2021,China,Oman,1,1,World Cup qualifier,United Arab Emirates,0,0
2986,11/11/2021,Lebanon,Iran,1,2,World Cup qualifier,Lebanon,1,-1
2987,11/11/2021,South Korea,United Arab Emirates,1,0,World Cup qualifier,South Korea,1,1
2988,11/11/2021,Iraq,Syria,1,1,World Cup qualifier,Qatar,0,0
2989,11/11/2021,Kyrgyzstan,Singapore,2,1,Friendly,United Arab Emirates,0,1
2990,11/11/2021,Czechia,Kuwait,7,0,Friendly,Czechia,1,7
2991,11/11/2021,Serbia,Qatar,4,0,Friendly,Serbia,1,4
2992,11/11/2021,South Africa,Zimbabwe,1,0,World Cup qualifier,South Africa,1,1
2993,11/11/2021,Uganda,Kenya,1,1,World Cup qualifier,Uganda,1,0
2994,11/11/2021,Tanzania,DR Congo,0,3,World Cup qualifier,Tanzania,1,-3
2995,11/11/2021,Benin,Madagascar,2,0,World Cup qualifier,Benin,1,2
2996,11/11/2021,Ethiopia,Ghana,1,1,World Cup qualifier,South Africa,0,0
2997,11/11/2021,Togo,Senegal,1,1,World Cup qualifier,Togo,1,0
2998,11/11/2021,Rwanda,Mali,0,3,World Cup qualifier,Rwanda,1,-3
2999,11/11/2021,Congo,Namibia,1,1,World Cup qualifier,Congo,1,0
3000,11/11/2021,Paraguay,Chile,0,1,World Cup qualifier,Paraguay,1,-1
3001,11/11/2021,Brazil,Colombia,1,0,World Cup qualifier,Brazil,1,1
3002,11/11/2021,Peru,Bolivia,3,0,World Cup qualifier,Peru,1,3
3003,11/11/2021,Ecuador,Venezuela,1,0,World Cup qualifier,Ecuador,1,1
3004,11/11/2021,Germany,Liechtenstein,9,0,World Cup qualifier,Germany,1,9
3005,11/11/2021,Georgia,Sweden,2,0,World Cup qualifier,Georgia,1,2
3006,11/11/2021,Azerbaijan,Luxembourg,1,3,World Cup qualifier,Azerbaijan,1,-2
3007,11/11/2021,Russia,Cyprus,6,0,World Cup qualifier,Russia,1,6
3008,11/11/2021,Greece,Spain,0,1,World Cup qualifier,Greece,1,-1
3009,11/11/2021,Ireland,Portugal,0,0,World Cup qualifier,Ireland,1,0
3010,11/11/2021,Romania,Iceland,0,0,World Cup qualifier,Romania,1,0
3011,11/11/2021,Ukraine,Bulgaria,1,1,Friendly,Ukraine,1,0
3012,11/11/2021,Slovakia,Slovenia,2,2,World Cup qualifier,Slovakia,1,0
3013,11/11/2021,Malta,Croatia,1,7,World Cup qualifier,Malta,1,-6
3014,11/11/2021,Armenia,North Macedonia,0,5,World Cup qualifier,Armenia,1,-5
3015,11/12/2021,Angola,Egypt,2,2,World Cup qualifier,Angola,1,0
3016,11/12/2021,Algeria,Djibouti,4,0,World Cup qualifier,Egypt,0,4
3017,11/12/2021,Guinea,Guinea-Bissau,0,0,World Cup qualifier,Guinea,1,0
3018,11/12/2021,Morocco,Sudan,3,0,World Cup qualifier,Morocco,1,3
3019,11/12/2021,Gabon,Libya,1,0,World Cup qualifier,Gabon,1,1
3020,11/12/2021,Burkina Faso,Niger,1,1,World Cup qualifier,Morocco,0,0
3021,11/12/2021,United States,Mexico,2,0,World Cup qualifier,United States,1,2
3022,11/12/2021,Canada,Costa Rica,1,0,World Cup qualifier,Canada,1,1
3023,11/12/2021,El Salvador,Jamaica,1,1,World Cup qualifier,El Salvador,1,0
3024,11/12/2021,Honduras,Panama,2,3,World Cup qualifier,Honduras,1,-1
3025,11/12/2021,Uruguay,Argentina,0,1,World Cup qualifier,Uruguay,1,-1
3026,11/12/2021,Moldova,Scotland,0,2,World Cup qualifier,Moldova,1,-2
3027,11/12/2021,England,Albania,5,0,World Cup qualifier,England,1,5
3028,11/12/2021,Northern Ireland,Lithuania,1,0,World Cup qualifier,Northern Ireland,1,1
3029,11/12/2021,Austria,Israel,4,2,World Cup qualifier,Austria,1,2
3030,11/12/2021,Hungary,San Marino,4,0,World Cup qualifier,Hungary,1,4
3031,11/12/2021,Italy,Switzerland,1,1,World Cup qualifier,Italy,1,0
3032,11/12/2021,Denmark,Faroe Islands,3,1,World Cup qualifier,Denmark,1,2
3033,11/12/2021,Andorra,Poland,1,4,World Cup qualifier,Andorra,1,-3
3034,11/13/2021,Burundi,Myanmar,2,1,Friendly,Turkey,0,1
3035,11/13/2021,Sri Lanka,Seychelles,0,1,Friendly tournament,Sri Lanka,1,-1
3036,11/13/2021,Bangladesh,Maldives,2,1,Friendly tournament,Sri Lanka,0,1
3037,11/13/2021,Zambia,Mauritania,4,0,World Cup qualifier,Zambia,1,4
3038,11/13/2021,Comoros,Sierra Leone,2,0,Friendly,Turkey,0,2
3039,11/13/2021,Nigeria,Liberia,2,0,World Cup qualifier,Morocco,0,2
3040,11/13/2021,Equatorial Guinea,Tunisia,1,0,World Cup qualifier,Equatorial Guinea,1,1
3041,11/13/2021,Cameroon,Malawi,4,0,World Cup qualifier,South Africa,0,4
3042,11/13/2021,Cape Verde,Central African Republic,2,1,World Cup qualifier,Cape Verde,1,1
3043,11/13/2021,Ivory Coast,Mozambique,3,0,World Cup qualifier,Benin,0,3
3044,11/13/2021,Nicaragua,Cuba,2,0,Friendly,Nicaragua,1,2
3045,11/13/2021,Wales,Belarus,5,1,World Cup qualifier,Wales,1,4
3046,11/13/2021,Belgium,Estonia,3,1,World Cup qualifier,Belgium,1,2
3047,11/13/2021,France,Kazakhstan,8,0,World Cup qualifier,France,1,8
3048,11/13/2021,Montenegro,Netherlands,2,2,World Cup qualifier,Montenegro,1,0
3049,11/13/2021,Norway,Latvia,0,0,World Cup qualifier,Norway,1,0
3050,11/13/2021,Bosnia and Herzegovina,Finland,1,3,World Cup qualifier,Bosnia and Herzegovina,1,-2
3051,11/13/2021,Turkey,Gibraltar,6,0,World Cup qualifier,Turkey,1,6
3052,11/14/2021,Azerbaijan,Qatar,2,2,Friendly,Azerbaijan,1,0
3053,11/14/2021,Ghana,South Africa,1,0,World Cup qualifier,Ghana,1,1
3054,11/14/2021,Mali,Uganda,1,0,World Cup qualifier,Morocco,0,1
3055,11/14/2021,Madagascar,Tanzania,1,1,World Cup qualifier,Madagascar,1,0
3056,11/14/2021,Zimbabwe,Ethiopia,1,1,World Cup qualifier,Zimbabwe,1,0
3057,11/14/2021,DR Congo,Benin,2,0,World Cup qualifier,DR Congo,1,2
3058,11/14/2021,Senegal,Congo,2,0,World Cup qualifier,Senegal,1,2
3059,11/14/2021,Armenia,Germany,1,4,World Cup qualifier,Armenia,1,-3
3060,11/14/2021,Spain,Sweden,1,0,World Cup qualifier,Spain,1,1
3061,11/14/2021,Luxembourg,Ireland,0,3,World Cup qualifier,Luxembourg,1,-3
3062,11/14/2021,Croatia,Russia,1,0,World Cup qualifier,Croatia,1,1
3063,11/14/2021,Portugal,Serbia,1,2,World Cup qualifier,Portugal,1,-1
3064,11/14/2021,Liechtenstein,Romania,0,2,World Cup qualifier,Liechtenstein,1,-2
3065,11/14/2021,Greece,Kosovo,1,1,World Cup qualifier,Greece,1,0
3066,11/14/2021,Malta,Slovakia,0,6,World Cup qualifier,Malta,1,-6
3067,11/14/2021,North Macedonia,Iceland,3,1,World Cup qualifier,North Macedonia,1,2
3068,11/14/2021,Slovenia,Cyprus,2,1,World Cup qualifier,Slovenia,1,1
3069,11/15/2021,Lithuania,Kuwait,1,1,Friendly,Lithuania,1,0
3070,11/15/2021,Georgia,Uzbekistan,1,0,Friendly,Georgia,1,1
3071,11/15/2021,Kenya,Rwanda,2,1,World Cup qualifier,Kenya,1,1
3072,11/15/2021,Niger,Djibouti,7,2,World Cup qualifier,Niger,1,5
3073,11/15/2021,Guinea-Bissau,Sudan,0,0,World Cup qualifier,Morocco,0,0
3074,11/15/2021,Namibia,Togo,0,1,World Cup qualifier,South Africa,0,-1
3075,11/15/2021,Scotland,Denmark,2,0,World Cup qualifier,Scotland,1,2
3076,11/15/2021,San Marino,England,0,10,World Cup qualifier,San Marino,1,-10
3077,11/15/2021,Northern Ireland,Italy,0,0,World Cup qualifier,Northern Ireland,1,0
3078,11/15/2021,Austria,Moldova,4,1,World Cup qualifier,Austria,1,3
3079,11/15/2021,Poland,Hungary,1,2,World Cup qualifier,Poland,1,-1
3080,11/15/2021,Switzerland,Bulgaria,4,0,World Cup qualifier,Switzerland,1,4
3081,11/15/2021,Israel,Faroe Islands,3,2,World Cup qualifier,Israel,1,1
3082,11/15/2021,Albania,Andorra,1,0,World Cup qualifier,Albania,1,1
3083,11/16/2021,Oman,Japan,0,1,World Cup qualifier,Oman,1,-1
3084,11/16/2021,Australia,China,1,1,World Cup qualifier,United Arab Emirates,0,0
3085,11/16/2021,Afghanistan,Indonesia,1,0,Friendly,Turkey,0,1
3086,11/16/2021,Lebanon,United Arab Emirates,0,1,World Cup qualifier,Lebanon,1,-1
3087,11/16/2021,Iran,Syria,3,0,World Cup qualifier,Jordan,0,3
3088,11/16/2021,South Korea,Iraq,3,0,World Cup qualifier,Qatar,0,3
3089,11/16/2021,Vietnam,Saudi Arabia,0,1,World Cup qualifier,Vietnam,1,-1
3090,11/16/2021,Sri Lanka,Bangladesh,2,1,Friendly tournament,Sri Lanka,1,1
3091,11/16/2021,Bahrain,Kyrgyzstan,4,2,Friendly,Bahrain,1,2
3092,11/16/2021,Belarus,Jordan,1,0,Friendly,Belarus,1,1
3093,11/16/2021,Kazakhstan,Tajikistan,1,0,Friendly,Kazakhstan,1,1
3094,11/16/2021,Maldives,Seychelles,0,0,Friendly tournament,Sri Lanka,0,0
3095,11/16/2021,Egypt,Gabon,2,1,World Cup qualifier,Egypt,1,1
3096,11/16/2021,Tunisia,Zambia,3,1,World Cup qualifier,Tunisia,1,2
3097,11/16/2021,Nigeria,Cape Verde,1,1,World Cup qualifier,Nigeria,1,0
3098,11/16/2021,New Zealand,Gambia,2,0,Friendly,United Arab Emirates,0,2
3099,11/16/2021,Libya,Angola,1,1,World Cup qualifier,Libya,1,0
3100,11/16/2021,Mozambique,Malawi,1,0,World Cup qualifier,Benin,0,1
3101,11/16/2021,Morocco,Guinea,3,0,World Cup qualifier,Morocco,1,3
3102,11/16/2021,Cameroon,Ivory Coast,1,0,World Cup qualifier,Cameroon,1,1
3103,11/16/2021,Liberia,Central African Republic,3,1,World Cup qualifier,Morocco,0,2
3104,11/16/2021,Algeria,Burkina Faso,2,2,World Cup qualifier,Algeria,1,0
3105,11/16/2021,Mauritania,Equatorial Guinea,1,1,World Cup qualifier,Mauritania,1,0
3106,11/16/2021,Jamaica,United States,1,1,World Cup qualifier,Jamaica,1,0
3107,11/16/2021,Canada,Mexico,2,1,World Cup qualifier,Canada,1,1
3108,11/16/2021,Costa Rica,Honduras,2,1,World Cup qualifier,Costa Rica,1,1
3109,11/16/2021,Panama,El Salvador,2,1,World Cup qualifier,Panama,1,1
3110,11/16/2021,Bolivia,Uruguay,3,0,World Cup qualifier,Bolivia,1,3
3111,11/16/2021,Argentina,Brazil,0,0,World Cup qualifier,Argentina,1,0
3112,11/16/2021,Chile,Ecuador,0,2,World Cup qualifier,Chile,1,-2
3113,11/16/2021,Colombia,Paraguay,0,0,World Cup qualifier,Colombia,1,0
3114,11/16/2021,Venezuela,Peru,1,2,World Cup qualifier,Venezuela,1,-1
3115,11/16/2021,Wales,Belgium,1,1,World Cup qualifier,Wales,1,0
3116,11/16/2021,Finland,France,0,2,World Cup qualifier,Finland,1,-2
3117,11/16/2021,Netherlands,Norway,2,0,World Cup qualifier,Netherlands,1,2
3118,11/16/2021,Czechia,Estonia,2,0,World Cup qualifier,Czechia,1,2
3119,11/16/2021,Gibraltar,Latvia,1,3,World Cup qualifier,Gibraltar,1,-2
3120,11/16/2021,Montenegro,Turkey,1,2,World Cup qualifier,Montenegro,1,-1
3121,11/16/2021,Bosnia and Herzegovina,Ukraine,0,2,World Cup qualifier,Bosnia and Herzegovina,1,-2
3122,11/19/2021,Sri Lanka,Seychelles,3,3,Friendly tournament,Sri Lanka,1,0
3123,11/25/2021,Indonesia,Myanmar,4,1,Friendly,Turkey,0,3
3124,11/30/2021,United Arab Emirates,Syria,2,1,Arab Cup,Qatar,0,1
3125,11/30/2021,Iraq,Oman,1,1,Arab Cup,Qatar,0,0
3126,11/30/2021,Qatar,Bahrain,1,0,Arab Cup,Qatar,1,1
3127,11/30/2021,Tunisia,Mauritania,5,1,Arab Cup,Qatar,0,4
3128,12/1/2021,Egypt,Lebanon,1,0,Arab Cup,Qatar,0,1
3129,12/1/2021,Jordan,Saudi Arabia,1,0,Arab Cup,Qatar,0,1
3130,12/1/2021,Morocco,Palestine,4,0,Arab Cup,Qatar,0,4
3131,12/1/2021,Algeria,Sudan,4,0,Arab Cup,Qatar,0,4
3132,12/3/2021,Syria,Tunisia,2,0,Arab Cup,Qatar,0,2
3133,12/3/2021,Bahrain,Iraq,0,0,Arab Cup,Qatar,0,0
3134,12/3/2021,Qatar,Oman,2,1,Arab Cup,Qatar,1,1
3135,12/3/2021,United Arab Emirates,Mauritania,1,0,Arab Cup,Qatar,0,1
3136,12/4/2021,Algeria,Lebanon,2,0,Arab Cup,Qatar,0,2
3137,12/4/2021,Morocco,Jordan,4,0,Arab Cup,Qatar,0,4
3138,12/4/2021,Palestine,Saudi Arabia,1,1,Arab Cup,Qatar,0,0
3139,12/4/2021,Egypt,Sudan,5,0,Arab Cup,Qatar,0,5
3140,12/4/2021,Ecuador,El Salvador,1,1,Friendly,United States,0,0
3141,12/5/2021,Singapore,Myanmar,3,0,Southeast Asian Champ,Singapore,1,3
3142,12/5/2021,Thailand,East Timor,2,0,Southeast Asian Champ,Singapore,0,2
3143,12/6/2021,Vietnam,Laos,2,0,Southeast Asian Champ,Singapore,0,2
3144,12/6/2021,Mauritania,Syria,2,1,Arab Cup,Qatar,0,1
3145,12/6/2021,Malaysia,Cambodia,3,1,Southeast Asian Champ,Singapore,0,2
3146,12/6/2021,Qatar,Iraq,3,0,Arab Cup,Qatar,1,3
3147,12/6/2021,Oman,Bahrain,3,0,Arab Cup,Qatar,0,3
3148,12/6/2021,Tunisia,United Arab Emirates,1,0,Arab Cup,Qatar,0,1
3149,12/7/2021,Lebanon,Sudan,1,0,Arab Cup,Qatar,0,1
3150,12/7/2021,Jordan,Palestine,5,1,Arab Cup,Qatar,0,4
3151,12/7/2021,Morocco,Saudi Arabia,1,0,Arab Cup,Qatar,0,1
3152,12/7/2021,Algeria,Egypt,1,1,Arab Cup,Qatar,0,0
3153,12/8/2021,Singapore,Philippines,2,1,Southeast Asian Champ,Singapore,1,1
3154,12/8/2021,Myanmar,East Timor,2,0,Southeast Asian Champ,Singapore,0,2
3155,12/8/2021,Chile,Mexico,2,2,Friendly,United States,0,0
3156,12/9/2021,Indonesia,Cambodia,4,2,Southeast Asian Champ,Singapore,0,2
3157,12/9/2021,Malaysia,Laos,4,0,Southeast Asian Champ,Singapore,0,4
3158,12/9/2021,Tanzania,Uganda,0,2,Friendly,Tanzania,1,-2
3159,12/10/2021,Tunisia,Oman,2,1,Arab Cup,Qatar,0,1
3160,12/10/2021,Qatar,United Arab Emirates,5,0,Arab Cup,Qatar,1,5
3161,12/11/2021,Philippines,East Timor,7,0,Southeast Asian Champ,Singapore,0,7
3162,12/11/2021,Thailand,Myanmar,4,0,Southeast Asian Champ,Singapore,0,4
3163,12/11/2021,Egypt,Jordan,3,1,Arab Cup,Qatar,0,2
3164,12/11/2021,Algeria,Morocco,2,2,Arab Cup,Qatar,0,0
3165,12/11/2021,Chile,El Salvador,1,0,Friendly,United States,0,1
3166,12/12/2021,Indonesia,Laos,5,1,Southeast Asian Champ,Singapore,0,4
3167,12/12/2021,Vietnam,Malaysia,3,0,Southeast Asian Champ,Singapore,0,3
3168,12/14/2021,Thailand,Philippines,2,1,Southeast Asian Champ,Singapore,0,1
3169,12/14/2021,Singapore,East Timor,2,0,Southeast Asian Champ,Singapore,1,2
3170,12/15/2021,Indonesia,Vietnam,0,0,Southeast Asian Champ,Singapore,0,0
3171,12/15/2021,Cambodia,Laos,3,0,Southeast Asian Champ,Singapore,0,3
3172,12/15/2021,Qatar,Algeria,1,2,Arab Cup,Qatar,1,-1
3173,12/15/2021,Tunisia,Egypt,1,0,Arab Cup,Qatar,0,1
3174,12/18/2021,Philippines,Myanmar,3,2,Southeast Asian Champ,Singapore,0,1
3175,12/18/2021,Singapore,Thailand,0,2,Southeast Asian Champ,Singapore,1,-2
3176,12/18/2021,Qatar,Egypt,0,0,Arab Cup,Qatar,1,0
3177,12/18/2021,Algeria,Tunisia,2,0,Arab Cup,Qatar,0,2
3178,12/18/2021,United States,Bosnia and Herzegovina,1,0,Friendly,United States,1,1
3179,12/19/2021,Indonesia,Malaysia,4,1,Southeast Asian Champ,Singapore,0,3
3180,12/19/2021,Vietnam,Cambodia,4,0,Southeast Asian Champ,Singapore,0,4
3181,12/22/2021,Singapore,Indonesia,1,1,Southeast Asian Champ,Singapore,1,0
3182,12/23/2021,Thailand,Vietnam,2,0,Southeast Asian Champ,Singapore,0,2
3183,12/25/2021,Singapore,Indonesia,2,4,Southeast Asian Champ,Singapore,1,-2
3184,12/26/2021,Thailand,Vietnam,0,0,Southeast Asian Champ,Singapore,0,0
3185,12/29/2021,Thailand,Indonesia,4,0,Southeast Asian Champ,Singapore,0,4
3186,12/30/2021,Ethiopia,Sudan,3,2,Friendly,Cameroon,0,1
3187,12/30/2021,Burkina Faso,Mauritania,0,0,Friendly,United Arab Emirates,0,0
3188,12/31/2021,Malawi,Comoros,2,1,Friendly,Saudi Arabia,0,1
3189,1/1/2022,Indonesia,Thailand,2,2,Southeast Asian Champ,Singapore,0,0
3190,1/2/2022,Sudan,Zimbabwe,0,0,Friendly,Cameroon,0,0
3191,1/2/2022,Burkina Faso,Gabon,3,0,Friendly,United Arab Emirates,0,3
3192,1/3/2022,Rwanda,Guinea,3,0,Friendly,Rwanda,1,3
3193,1/4/2022,Gabon,Mauritania,1,1,Friendly,United Arab Emirates,0,0
3194,1/5/2022,Algeria,Ghana,3,0,Friendly,Qatar,0,3
3195,1/6/2022,Rwanda,Guinea,0,2,Friendly,Rwanda,1,-2
3196,1/9/2022,Cape Verde,Ethiopia,1,0,African Nations Cup,Cameroon,0,1
3197,1/9/2022,Cameroon,Burkina Faso,2,1,African Nations Cup,Cameroon,1,1
3198,1/10/2022,Senegal,Zimbabwe,1,0,African Nations Cup,Cameroon,0,1
3199,1/10/2022,Morocco,Ghana,1,0,African Nations Cup,Cameroon,0,1
3200,1/10/2022,Guinea,Malawi,1,0,African Nations Cup,Cameroon,0,1
3201,1/10/2022,Gabon,Comoros,1,0,African Nations Cup,Cameroon,0,1
3202,1/11/2022,Nigeria,Egypt,1,0,African Nations Cup,Cameroon,0,1
3203,1/11/2022,Algeria,Sierra Leone,0,0,African Nations Cup,Cameroon,0,0
3204,1/11/2022,Guinea-Bissau,Sudan,0,0,African Nations Cup,Cameroon,0,0
3205,1/12/2022,Iceland,Uganda,1,1,Friendly,Turkey,0,0
3206,1/12/2022,Gambia,Mauritania,1,0,African Nations Cup,Cameroon,0,1
3207,1/12/2022,Mali,Tunisia,1,0,African Nations Cup,Cameroon,0,1
3208,1/12/2022,Ivory Coast,Equatorial Guinea,1,0,African Nations Cup,Cameroon,0,1
3209,1/13/2022,Cameroon,Ethiopia,4,1,African Nations Cup,Cameroon,1,3
3210,1/13/2022,Burkina Faso,Cape Verde,1,0,African Nations Cup,Cameroon,0,1
3211,1/14/2022,Malawi,Zimbabwe,2,1,African Nations Cup,Cameroon,0,1
3212,1/14/2022,Gabon,Ghana,1,1,African Nations Cup,Cameroon,0,0
3213,1/14/2022,Morocco,Comoros,2,0,African Nations Cup,Cameroon,0,2
3214,1/14/2022,Guinea,Senegal,0,0,African Nations Cup,Cameroon,0,0
3215,1/15/2022,South Korea,Iceland,5,1,Friendly,Turkey,0,4
3216,1/15/2022,Egypt,Guinea-Bissau,1,0,African Nations Cup,Cameroon,0,1
3217,1/15/2022,Nigeria,Sudan,3,1,African Nations Cup,Cameroon,0,2
3218,1/16/2022,Ivory Coast,Sierra Leone,2,2,African Nations Cup,Cameroon,0,0
3219,1/16/2022,Gambia,Mali,1,1,African Nations Cup,Cameroon,0,0
3220,1/16/2022,Tunisia,Mauritania,4,0,African Nations Cup,Cameroon,0,4
3221,1/16/2022,Equatorial Guinea,Algeria,1,0,African Nations Cup,Cameroon,0,1
3222,1/16/2022,Colombia,Honduras,2,1,Friendly,United States,0,1
3223,1/16/2022,Peru,Panama,1,1,Friendly,Peru,1,0
3224,1/17/2022,Burkina Faso,Ethiopia,1,1,African Nations Cup,Cameroon,0,0
3225,1/17/2022,Cameroon,Cape Verde,1,1,African Nations Cup,Cameroon,1,0
3226,1/18/2022,Uganda,Moldova,3,2,Friendly,Turkey,0,1
3227,1/18/2022,Zimbabwe,Guinea,2,1,African Nations Cup,Cameroon,0,1
3228,1/18/2022,Comoros,Ghana,3,2,African Nations Cup,Cameroon,0,1
3229,1/18/2022,Malawi,Senegal,0,0,African Nations Cup,Cameroon,0,0
3230,1/18/2022,Gabon,Morocco,2,2,African Nations Cup,Cameroon,0,0
3231,1/19/2022,Egypt,Sudan,1,0,African Nations Cup,Cameroon,0,1
3232,1/19/2022,Nigeria,Guinea-Bissau,2,0,African Nations Cup,Cameroon,0,2
3233,1/20/2022,Equatorial Guinea,Sierra Leone,1,0,African Nations Cup,Cameroon,0,1
3234,1/20/2022,Gambia,Tunisia,1,0,African Nations Cup,Cameroon,0,1
3235,1/20/2022,Mali,Mauritania,2,0,African Nations Cup,Cameroon,0,2
3236,1/20/2022,Ivory Coast,Algeria,3,1,African Nations Cup,Cameroon,0,2
3237,1/20/2022,Peru,Jamaica,3,0,Friendly,Peru,1,3
3238,1/21/2022,South Korea,Moldova,4,0,Friendly,Turkey,0,4
3239,1/21/2022,Iraq,Uganda,1,0,Friendly,Iraq,1,1
3240,1/21/2022,Bolivia,Trinidad and Tobago,5,0,Friendly,Bolivia,1,5
3241,1/23/2022,Tunisia,Nigeria,1,0,African Nations Cup,Cameroon,0,1
3242,1/23/2022,Burkina Faso,Gabon,1,1,African Nations Cup,Cameroon,0,0
3243,1/24/2022,Gambia,Guinea,1,0,African Nations Cup,Cameroon,0,1
3244,1/24/2022,Cameroon,Comoros,2,1,African Nations Cup,Cameroon,1,1
3245,1/25/2022,Morocco,Malawi,2,1,African Nations Cup,Cameroon,0,1
3246,1/25/2022,Senegal,Cape Verde,2,0,African Nations Cup,Cameroon,0,2
3247,1/26/2022,Egypt,Ivory Coast,0,0,African Nations Cup,Cameroon,0,0
3248,1/26/2022,Equatorial Guinea,Mali,0,0,African Nations Cup,Cameroon,0,0
3249,1/27/2022,Japan,China,2,0,World Cup qualifier,Japan,1,2
3250,1/27/2022,Australia,Vietnam,4,0,World Cup qualifier,Australia,1,4
3251,1/27/2022,Indonesia,East Timor,4,1,Friendly,Indonesia,1,3
3252,1/27/2022,Lebanon,South Korea,0,1,World Cup qualifier,Lebanon,1,-1
3253,1/27/2022,Iran,Iraq,1,0,World Cup qualifier,Iran,1,1
3254,1/27/2022,United Arab Emirates,Syria,2,0,World Cup qualifier,United Arab Emirates,1,2
3255,1/27/2022,Saudi Arabia,Oman,1,0,World Cup qualifier,Saudi Arabia,1,1
3256,1/27/2022,Bahrain,Uganda,3,1,Friendly,Bahrain,1,2
3257,1/27/2022,Uzbekistan,South Sudan,3,0,Friendly,United Arab Emirates,0,3
3258,1/27/2022,United States,El Salvador,1,0,World Cup qualifier,United States,1,1
3259,1/27/2022,Honduras,Canada,0,2,World Cup qualifier,Honduras,1,-2
3260,1/27/2022,Costa Rica,Panama,1,0,World Cup qualifier,Costa Rica,1,1
3261,1/27/2022,Jamaica,Mexico,1,2,World Cup qualifier,Jamaica,1,-1
3262,1/27/2022,Anguilla,British Virgin Islands,2,1,Friendly,England,0,1
3263,1/27/2022,Paraguay,Uruguay,0,1,World Cup qualifier,Paraguay,1,-1
3264,1/27/2022,Chile,Argentina,1,2,World Cup qualifier,Chile,1,-1
3265,1/27/2022,Ecuador,Brazil,1,1,World Cup qualifier,Ecuador,1,0
3266,1/28/2022,Jordan,New Zealand,3,1,Friendly,United Arab Emirates,0,2
3267,1/28/2022,Suriname,Barbados,1,0,Friendly tournament,Suriname,1,1
3268,1/28/2022,Venezuela,Bolivia,4,1,World Cup qualifier,Venezuela,1,3
3269,1/28/2022,Colombia,Peru,0,1,World Cup qualifier,Colombia,1,-1
3270,1/29/2022,Kuwait,Libya,2,0,Friendly,Kuwait,1,2
3271,1/29/2022,Nepal,Mauritius,1,0,Friendly,Nepal,1,1
3272,1/29/2022,Cameroon,Gambia,2,0,African Nations Cup,Cameroon,1,2
3273,1/29/2022,Burkina Faso,Tunisia,1,0,African Nations Cup,Cameroon,0,1
3274,1/29/2022,Nicaragua,Belize,4,0,Friendly,Nicaragua,1,4
3275,1/30/2022,Indonesia,East Timor,3,0,Friendly,Indonesia,1,3
3276,1/30/2022,Egypt,Morocco,2,1,African Nations Cup,Cameroon,0,1
3277,1/30/2022,Senegal,Equatorial Guinea,3,1,African Nations Cup,Cameroon,0,2
3278,1/30/2022,Canada,United States,2,0,World Cup qualifier,Canada,1,2
3279,1/30/2022,Mexico,Costa Rica,0,0,World Cup qualifier,Mexico,1,0
3280,1/30/2022,Honduras,El Salvador,0,2,World Cup qualifier,Honduras,1,-2
3281,1/30/2022,Panama,Jamaica,3,2,World Cup qualifier,Panama,1,1
3282,1/30/2022,Barbados,Guyana,0,0,Friendly tournament,Suriname,0,0
3283,1/31/2022,Jordan,South Sudan,2,1,Friendly,United Arab Emirates,0,1
3284,2/1/2022,Japan,Saudi Arabia,2,0,World Cup qualifier,Japan,1,2
3285,2/1/2022,Oman,Australia,2,2,World Cup qualifier,Oman,1,0
3286,2/1/2022,Vietnam,China,3,1,World Cup qualifier,Vietnam,1,2
3287,2/1/2022,Lebanon,Iraq,1,1,World Cup qualifier,Lebanon,1,0
3288,2/1/2022,Iran,United Arab Emirates,1,0,World Cup qualifier,Iran,1,1
3289,2/1/2022,South Korea,Syria,2,0,World Cup qualifier,United Arab Emirates,0,2
3290,2/1/2022,Kuwait,Libya,0,2,Friendly,Kuwait,1,-2
3291,2/1/2022,Bahrain,DR Congo,1,0,Friendly,Bahrain,1,1
3292,2/1/2022,Nepal,Mauritius,1,0,Friendly,Nepal,1,1
3293,2/1/2022,Suriname,Guyana,2,1,Friendly tournament,Suriname,1,1
3294,2/1/2022,Nicaragua,Belize,1,1,Friendly,Nicaragua,1,0
3295,2/1/2022,Uruguay,Venezuela,4,1,World Cup qualifier,Uruguay,1,3
3296,2/1/2022,Argentina,Colombia,1,0,World Cup qualifier,Argentina,1,1
3297,2/1/2022,Bolivia,Chile,2,3,World Cup qualifier,Bolivia,1,-1
3298,2/1/2022,Brazil,Paraguay,4,0,World Cup qualifier,Brazil,1,4
3299,2/1/2022,Peru,Ecuador,1,1,World Cup qualifier,Peru,1,0
3300,2/2/2022,Senegal,Burkina Faso,3,1,African Nations Cup,Cameroon,0,2
3301,2/2/2022,United States,Honduras,3,0,World Cup qualifier,United States,1,3
3302,2/2/2022,El Salvador,Canada,0,2,World Cup qualifier,El Salvador,1,-2
3303,2/2/2022,Jamaica,Costa Rica,0,1,World Cup qualifier,Jamaica,1,-1
3304,2/2/2022,Mexico,Panama,1,0,World Cup qualifier,Mexico,1,1
3305,2/3/2022,Cameroon,Egypt,0,0,African Nations Cup,Cameroon,1,0
3306,2/5/2022,Cameroon,Burkina Faso,3,3,African Nations Cup,Cameroon,1,0
3307,2/6/2022,Egypt,Senegal,0,0,African Nations Cup,Cameroon,0,0
3308,2/13/2022,Saint Martin,Anguilla,1,2,Friendly,Saint Martin,1,-1
3309,2/19/2022,Guam,Northern Mariana Islands,2,0,Friendly,Guam,1,2
3310,2/22/2022,Guam,Northern Mariana Islands,3,2,Friendly,Guam,1,1
3311,2/22/2022,Martinique,Barbados,3,1,Friendly,Martinique,1,2
3312,3/8/2022,Eswatini,Lesotho,0,0,Friendly,Eswatini,1,0
3313,3/8/2022,Eswatini,Lesotho,4,0,Friendly,Eswatini,1,4
3314,3/10/2022,Fiji,Vanuatu,3,0,Friendly,Qatar,0,3
3315,3/17/2022,Solomon Islands,Cook Islands,2,0,World Cup qualifier,Qatar,0,2
3316,3/18/2022,Iraq,Zambia,3,1,Friendly,Iraq,1,2
3317,3/18/2022,New Zealand,Papua New Guinea,1,0,World Cup qualifier,Qatar,0,1
3318,3/18/2022,Fiji,New Caledonia,2,1,World Cup qualifier,Qatar,0,1
3319,3/19/2022,Mauritius,Seychelles,0,0,Friendly,Mauritius,1,0
3320,3/21/2022,New Zealand,Fiji,4,0,World Cup qualifier,Qatar,0,4
3321,3/21/2022,Papua New Guinea,New Caledonia,1,0,World Cup qualifier,Qatar,0,1
3322,3/23/2022,Malaysia,Philippines,2,0,Friendly tournament,Singapore,0,2
3323,3/23/2022,Bahrain,India,2,1,Friendly,Bahrain,1,1
3324,3/23/2022,Laos,Mongolia,1,0,Friendly,Laos,1,1
3325,3/23/2022,Tanzania,Central African Republic,3,1,Friendly tournament,Tanzania,1,2
3326,3/23/2022,South Sudan,Djibouti,4,2,African Nations Cup qualifier,Egypt,0,2
3327,3/23/2022,Gambia,Chad,1,0,African Nations Cup qualifier,Cameroon,0,1
3328,3/23/2022,Guinea-Bissau,Equatorial Guinea,3,0,Friendly tournament,Portugal,0,3
3329,3/23/2022,Cape Verde,Guadeloupe,2,0,Friendly,France,0,2
3330,3/23/2022,Eswatini,Somalia,3,0,African Nations Cup qualifier,Tanzania,0,3
3331,3/23/2022,Mozambique,Niger,1,1,Friendly tournament,Mauritania,0,0
3332,3/23/2022,Lesotho,Seychelles,0,0,African Nations Cup qualifier,Mauritius,0,0
3333,3/23/2022,Gibraltar,Grenada,0,0,Friendly,Gibraltar,1,0
3334,3/24/2022,Australia,Japan,0,2,World Cup qualifier,Australia,1,-2
3335,3/24/2022,China,Saudi Arabia,1,1,World Cup qualifier,United Arab Emirates,0,0
3336,3/24/2022,Lebanon,Syria,0,3,World Cup qualifier,Lebanon,1,-3
3337,3/24/2022,South Korea,Iran,2,0,World Cup qualifier,South Korea,1,2
3338,3/24/2022,Vietnam,Oman,0,1,World Cup qualifier,Vietnam,1,-1
3339,3/24/2022,Thailand,Nepal,2,0,Friendly,Thailand,1,2
3340,3/24/2022,Iraq,United Arab Emirates,1,0,World Cup qualifier,Saudi Arabia,0,1
3341,3/24/2022,Maldives,Bangladesh,2,0,Friendly,Maldives,1,2
3342,3/24/2022,Mauritius,São Tomé and Príncipe,0,1,African Nations Cup qualifier,Mauritius,1,-1
3343,3/24/2022,Togo,Sierra Leone,3,0,Friendly,Turkey,0,3
3344,3/24/2022,Benin,Liberia,4,0,Friendly,Turkey,0,4
3345,3/24/2022,Kosovo,Burkina Faso,5,0,Friendly,Kosovo,1,5
3346,3/24/2022,Mexico,United States,0,0,World Cup qualifier,Mexico,1,0
3347,3/24/2022,Costa Rica,Canada,1,0,World Cup qualifier,Costa Rica,1,1
3348,3/24/2022,Jamaica,El Salvador,1,1,World Cup qualifier,Jamaica,1,0
3349,3/24/2022,Guatemala,Cuba,1,0,Friendly,Guatemala,1,1
3350,3/24/2022,Panama,Honduras,1,1,World Cup qualifier,Panama,1,0
3351,3/24/2022,Uruguay,Peru,1,0,World Cup qualifier,Uruguay,1,1
3352,3/24/2022,Brazil,Chile,4,0,World Cup qualifier,Brazil,1,4
3353,3/24/2022,Paraguay,Ecuador,3,1,World Cup qualifier,Paraguay,1,2
3354,3/24/2022,Colombia,Bolivia,3,0,World Cup qualifier,Colombia,1,3
3355,3/24/2022,New Zealand,New Caledonia,7,1,World Cup qualifier,Qatar,0,6
3356,3/24/2022,Papua New Guinea,Fiji,2,1,World Cup qualifier,Qatar,0,1
3357,3/24/2022,Solomon Islands,Tahiti,3,1,World Cup qualifier,Qatar,0,2
3358,3/24/2022,Scotland,Poland,1,1,Friendly,Scotland,1,0
3359,3/24/2022,Wales,Austria,2,1,World Cup qualifier,Wales,1,1
3360,3/24/2022,Hungary,Serbia,0,1,Friendly,Hungary,1,-1
3361,3/24/2022,Sweden,Czechia,1,0,World Cup qualifier,Sweden,1,1
3362,3/24/2022,Italy,North Macedonia,0,1,World Cup qualifier,Italy,1,-1
3363,3/24/2022,Estonia,Cyprus,0,0,European Nations League C,Estonia,1,0
3364,3/24/2022,Portugal,Turkey,3,1,World Cup qualifier,Portugal,1,2
3365,3/24/2022,Armenia,Montenegro,1,0,Friendly,Armenia,1,1
3366,3/24/2022,Moldova,Kazakhstan,1,2,European Nations League C,Moldova,1,-1
3367,3/25/2022,Uzbekistan,Kyrgyzstan,3,1,Friendly tournament,Uzbekistan,1,2
3368,3/25/2022,Kuwait,Latvia,1,1,Friendly,Malta,0,0
3369,3/25/2022,Tajikistan,Uganda,1,1,Friendly tournament,Uzbekistan,0,0
3370,3/25/2022,Egypt,Senegal,1,0,World Cup qualifier,Egypt,1,1
3371,3/25/2022,Guinea,South Africa,0,0,Friendly,Belgium,0,0
3372,3/25/2022,Zambia,Congo,3,1,Friendly,Turkey,0,2
3373,3/25/2022,Comoros,Ethiopia,2,1,Friendly,Comoros,1,1
3374,3/25/2022,DR Congo,Morocco,1,1,World Cup qualifier,DR Congo,1,0
3375,3/25/2022,Ghana,Nigeria,0,0,World Cup qualifier,Ghana,1,0
3376,3/25/2022,Mali,Tunisia,0,1,World Cup qualifier,Mali,1,-1
3377,3/25/2022,Cape Verde,Liechtenstein,6,0,Friendly,Spain,0,6
3378,3/25/2022,Cameroon,Algeria,0,1,World Cup qualifier,Cameroon,1,-1
3379,3/25/2022,France,Ivory Coast,2,1,Friendly,France,1,1
3380,3/25/2022,Trinidad and Tobago,Barbados,9,0,Friendly tournament,Trinidad and Tobago,1,9
3381,3/25/2022,Andorra,Saint Kitts and Nevis,1,0,Friendly,Andorra,1,1
3382,3/25/2022,Argentina,Venezuela,3,0,World Cup qualifier,Argentina,1,3
3383,3/25/2022,Luxembourg,Northern Ireland,1,3,Friendly,Luxembourg,1,-2
3384,3/25/2022,Norway,Slovakia,2,0,Friendly,Norway,1,2
3385,3/25/2022,Romania,Greece,0,1,Friendly,Romania,1,-1
3386,3/25/2022,San Marino,Lithuania,1,2,Friendly,San Marino,1,-1
3387,3/25/2022,Malta,Azerbaijan,1,0,Friendly,Malta,1,1
3388,3/25/2022,Bosnia and Herzegovina,Georgia,0,1,Friendly,Bosnia and Herzegovina,1,-1
3389,3/26/2022,Belarus,India,3,0,Friendly,Bahrain,0,3
3390,3/26/2022,Singapore,Malaysia,2,1,Friendly tournament,Singapore,1,1
3391,3/26/2022,Bahrain,Burundi,1,0,Friendly,Bahrain,1,1
3392,3/26/2022,Qatar,Bulgaria,2,1,Friendly,Qatar,1,1
3393,3/26/2022,Angola,Guinea-Bissau,3,2,Friendly tournament,Portugal,0,1
3394,3/26/2022,Central African Republic,Sudan,0,0,Friendly tournament,Tanzania,0,0
3395,3/26/2022,Libya,Niger,2,1,Friendly tournament,Mauritania,0,1
3396,3/26/2022,Mauritania,Mozambique,2,1,Friendly tournament,Mauritania,1,1
3397,3/26/2022,Martinique,Guadeloupe,4,3,Friendly,France,0,1
3398,3/26/2022,Saint Martin,Bahamas,2,0,Friendly,Saint Martin,1,2
3399,3/26/2022,England,Switzerland,2,1,Friendly,England,1,1
3400,3/26/2022,Ireland,Belgium,2,2,Friendly,Ireland,1,0
3401,3/26/2022,Netherlands,Denmark,4,2,Friendly,Netherlands,1,2
3402,3/26/2022,Germany,Israel,2,0,Friendly,Germany,1,2
3403,3/26/2022,Finland,Iceland,1,1,Friendly,Spain,0,0
3404,3/26/2022,Spain,Albania,2,1,Friendly,Spain,1,1
3405,3/26/2022,Croatia,Slovenia,1,1,Friendly,Qatar,0,0
3406,3/26/2022,Gibraltar,Faroe Islands,0,0,Friendly,Gibraltar,1,0
3407,3/27/2022,Thailand,Suriname,1,0,Friendly,Thailand,1,1
3408,3/27/2022,Laos,Brunei,3,2,Friendly,Laos,1,1
3409,3/27/2022,Benin,Zambia,2,1,Friendly,Turkey,0,1
3410,3/27/2022,Mauritius,São Tomé and Príncipe,3,3,African Nations Cup qualifier,Mauritius,1,0
3411,3/27/2022,South Sudan,Djibouti,1,0,African Nations Cup qualifier,Uganda,0,1
3412,3/27/2022,Sierra Leone,Liberia,1,0,Friendly,Turkey,0,1
3413,3/27/2022,Eswatini,Somalia,2,1,African Nations Cup qualifier,South Africa,0,1
3414,3/27/2022,Lesotho,Seychelles,3,1,African Nations Cup qualifier,South Africa,0,2
3415,3/27/2022,United States,Panama,5,1,World Cup qualifier,United States,1,4
3416,3/27/2022,Canada,Jamaica,4,0,World Cup qualifier,Canada,1,4
3417,3/27/2022,El Salvador,Costa Rica,1,2,World Cup qualifier,El Salvador,1,-1
3418,3/27/2022,Guatemala,Haiti,2,1,Friendly,United States,0,1
3419,3/27/2022,Honduras,Mexico,0,1,World Cup qualifier,Honduras,1,-1
3420,3/27/2022,Guyana,Barbados,5,0,Friendly tournament,Trinidad and Tobago,0,5
3421,3/27/2022,Belize,Cuba,0,3,Friendly,Belize,1,-3
3422,3/27/2022,New Zealand,Tahiti,1,0,World Cup qualifier,Qatar,0,1
3423,3/27/2022,Solomon Islands,Papua New Guinea,3,2,World Cup qualifier,Qatar,0,1
3424,3/28/2022,Cape Verde,San Marino,2,0,Friendly,Spain,0,2
3425,3/28/2022,Andorra,Grenada,1,0,Friendly,Andorra,1,1
3426,3/28/2022,Fiji,Vanuatu,2,1,Friendly,Qatar,0,1
3427,3/28/2022,Montenegro,Greece,1,0,Friendly,Montenegro,1,1
3428,3/29/2022,Japan,Vietnam,1,1,World Cup qualifier,Japan,1,0
3429,3/29/2022,Singapore,Philippines,2,0,Friendly tournament,Singapore,1,2
3430,3/29/2022,Saudi Arabia,Australia,1,0,World Cup qualifier,Saudi Arabia,1,1
3431,3/29/2022,Oman,China,2,0,World Cup qualifier,Oman,1,2
3432,3/29/2022,Iran,Lebanon,2,0,World Cup qualifier,Iran,1,2
3433,3/29/2022,Bangladesh,Mongolia,0,0,Friendly,Bangladesh,1,0
3434,3/29/2022,United Arab Emirates,South Korea,1,0,World Cup qualifier,United Arab Emirates,1,1
3435,3/29/2022,Iraq,Syria,1,1,World Cup qualifier,United Arab Emirates,0,0
3436,3/29/2022,Tajikistan,Kyrgyzstan,1,0,Friendly tournament,Uzbekistan,0,1
3437,3/29/2022,Malta,Kuwait,2,0,Friendly,Malta,1,2
3438,3/29/2022,Bahrain,Belarus,0,1,Friendly,Bahrain,1,-1
3439,3/29/2022,Qatar,Slovenia,0,0,Friendly,Qatar,1,0
3440,3/29/2022,Uzbekistan,Uganda,4,2,Friendly tournament,Uzbekistan,1,2
3441,3/29/2022,Senegal,Egypt,1,0,World Cup qualifier,Senegal,1,1
3442,3/29/2022,France,South Africa,5,0,Friendly,France,1,5
3443,3/29/2022,Tanzania,Sudan,1,1,Friendly tournament,Tanzania,1,0
3444,3/29/2022,Morocco,DR Congo,4,1,World Cup qualifier,Morocco,1,3
3445,3/29/2022,Sierra Leone,Congo,2,1,Friendly,Turkey,0,1
3446,3/29/2022,Nigeria,Ghana,1,1,World Cup qualifier,Nigeria,1,0
3447,3/29/2022,Chad,Gambia,2,2,African Nations Cup qualifier,Morocco,0,0
3448,3/29/2022,Burundi,Liberia,2,1,Friendly,Turkey,0,1
3449,3/29/2022,Benin,Togo,1,1,Friendly,Turkey,0,0
3450,3/29/2022,Tunisia,Mali,0,0,World Cup qualifier,Tunisia,1,0
3451,3/29/2022,Mauritania,Libya,2,0,Friendly tournament,Mauritania,1,2
3452,3/29/2022,Algeria,Cameroon,1,2,World Cup qualifier,Algeria,1,-1
3453,3/29/2022,Belgium,Burkina Faso,3,0,Friendly,Belgium,1,3
3454,3/29/2022,England,Ivory Coast,3,0,Friendly,England,1,3
3455,3/29/2022,Angola,Equatorial Guinea,0,0,Friendly tournament,Portugal,0,0
3456,3/29/2022,Trinidad and Tobago,Guyana,1,1,Friendly tournament,Trinidad and Tobago,1,0
3457,3/29/2022,Chile,Uruguay,0,2,World Cup qualifier,Chile,1,-2
3458,3/29/2022,Ecuador,Argentina,1,1,World Cup qualifier,Ecuador,1,0
3459,3/29/2022,Bolivia,Brazil,0,4,World Cup qualifier,Bolivia,1,-4
3460,3/29/2022,Peru,Paraguay,2,0,World Cup qualifier,Peru,1,2
3461,3/29/2022,Venezuela,Colombia,0,1,World Cup qualifier,Venezuela,1,-1
3462,3/29/2022,Austria,Scotland,2,2,Friendly,Austria,1,0
3463,3/29/2022,Wales,Czechia,1,1,Friendly,Wales,1,0
3464,3/29/2022,Northern Ireland,Hungary,0,1,Friendly,Northern Ireland,1,-1
3465,3/29/2022,Switzerland,Kosovo,1,1,Friendly,Switzerland,1,0
3466,3/29/2022,Netherlands,Germany,1,1,Friendly,Netherlands,1,0
3467,3/29/2022,Poland,Sweden,2,0,World Cup qualifier,Poland,1,2
3468,3/29/2022,Norway,Armenia,9,0,Friendly,Norway,1,9
3469,3/29/2022,Turkey,Italy,2,3,Friendly,Turkey,1,-1
3470,3/29/2022,Slovakia,Finland,2,0,Friendly,Spain,0,2
3471,3/29/2022,Bosnia and Herzegovina,Luxembourg,1,0,Friendly,Bosnia and Herzegovina,1,1
3472,3/29/2022,Denmark,Serbia,3,0,Friendly,Denmark,1,3
3473,3/29/2022,Cyprus,Estonia,2,0,European Nations League C,Cyprus,1,2
3474,3/29/2022,Spain,Iceland,5,0,Friendly,Spain,1,5
3475,3/29/2022,Portugal,North Macedonia,2,0,World Cup qualifier,Portugal,1,2
3476,3/29/2022,Israel,Romania,2,2,Friendly,Israel,1,0
3477,3/29/2022,Latvia,Azerbaijan,1,0,Friendly,Malta,0,1
3478,3/29/2022,Ireland,Lithuania,1,0,Friendly,Ireland,1,1
3479,3/29/2022,Croatia,Bulgaria,2,1,Friendly,Qatar,0,1
3480,3/29/2022,Albania,Georgia,0,0,Friendly,Albania,1,0
3481,3/29/2022,Kazakhstan,Moldova,0,1,European Nations League C,Kazakhstan,1,-1
3482,3/29/2022,Faroe Islands,Liechtenstein,1,0,Friendly,Spain,0,1
3483,3/30/2022,Costa Rica,United States,2,0,World Cup qualifier,Costa Rica,1,2
3484,3/30/2022,Panama,Canada,1,0,World Cup qualifier,Panama,1,1
3485,3/30/2022,Mexico,El Salvador,2,0,World Cup qualifier,Mexico,1,2
3486,3/30/2022,Jamaica,Honduras,2,1,World Cup qualifier,Jamaica,1,1
3487,3/30/2022,New Zealand,Solomon Islands,5,0,World Cup qualifier,Qatar,0,5
3488,4/16/2022,French Guiana,Guyana,2,1,Friendly,French Guiana,1,1
3489,4/18/2022,French Guiana,Guyana,1,2,Friendly,French Guiana,1,-1
3490,4/24/2022,Guatemala,El Salvador,4,0,Friendly,United States,0,4
3491,4/27/2022,Guatemala,Mexico,0,0,Friendly,United States,0,0
3492,5/1/2022,El Salvador,Panama,3,2,Friendly,United States,0,1
3493,5/12/2022,Dominica,St Vincent & Grenadines,2,1,Friendly,Dominica,1,1
3494,5/12/2022,Bahamas,Turks and Caicos Islands,4,2,Friendly,Bahamas,1,2
3495,5/14/2022,Bahamas,Turks and Caicos Islands,1,2,Friendly,Bahamas,1,-1
3496,5/15/2022,Dominica,St Vincent & Grenadines,3,1,Friendly,Dominica,1,2
3497,5/22/2022,French Guiana,Suriname,3,1,Friendly,French Guiana,1,2
3498,5/24/2022,Hong Kong,Myanmar,0,0,Friendly,Thailand,0,0
3499,5/24/2022,Thailand,Bahrain,3,1,Friendly,Thailand,1,2
3500,5/24/2022,Mozambique,Eswatini,0,1,Friendly,Mozambique,1,-1
3501,5/26/2022,Lesotho,Namibia,2,1,Friendly,South Africa,0,1
3502,5/27/2022,Bahrain,Myanmar,2,0,Friendly,Thailand,0,2
3503,5/27/2022,Malaysia,Brunei,4,0,Friendly,Malaysia,1,4
3504,5/27/2022,Thailand,Turkmenistan,1,0,Friendly,Thailand,1,1
3505,5/27/2022,Botswana,Eswatini,1,0,Friendly,South Africa,0,1
3506,5/28/2022,Jordan,India,2,0,Friendly,Qatar,0,2
3507,5/28/2022,East Timor,Nepal,2,2,Friendly,Qatar,0,0
3508,5/28/2022,Ethiopia,Lesotho,1,1,Friendly,Ethiopia,1,0
3509,5/28/2022,Mexico,Nigeria,2,1,Friendly,United States,0,1
3510,5/28/2022,Guyana,Saint Lucia,3,2,Friendly,Trinidad and Tobago,0,1
3511,5/29/2022,United Arab Emirates,Gambia,1,1,Friendly,United Arab Emirates,1,0
3512,5/29/2022,South Sudan,Sudan,0,0,Friendly,Morocco,0,0
3513,5/30/2022,Ethiopia,Lesotho,1,1,Friendly,Ethiopia,1,0
3514,5/30/2022,Trinidad and Tobago,Saint Lucia,1,0,Friendly,Trinidad and Tobago,1,1
3515,5/31/2022,Nepal,Sri Lanka,1,1,Friendly,Qatar,0,0
3516,5/31/2022,Thailand,Bahrain,1,2,Friendly,Thailand,1,-1
3517,6/1/2022,Australia,Jordan,2,1,Friendly,Qatar,0,1
3518,6/1/2022,Indonesia,Bangladesh,0,0,Friendly,Indonesia,1,0
3519,6/1/2022,Vietnam,Afghanistan,2,0,Friendly,Vietnam,1,2
3520,6/1/2022,Syria,Tajikistan,1,0,Friendly,United Arab Emirates,0,1
3521,6/1/2022,Malaysia,Hong Kong,2,0,Friendly,Malaysia,1,2
3522,6/1/2022,Kuwait,Singapore,2,0,Friendly,United Arab Emirates,0,2
3523,6/1/2022,Ghana,Madagascar,3,0,African Nations Cup qualifier,Ghana,1,3
3524,6/1/2022,Libya,Botswana,1,0,African Nations Cup qualifier,Libya,1,1
3525,6/1/2022,United States,Morocco,3,0,Friendly,United States,1,3
3526,6/1/2022,Angola,Central African Republic,2,1,African Nations Cup qualifier,Angola,1,1
3527,6/1/2022,Argentina,Italy,3,0,Intercontinental Champ,England,0,3
3528,6/1/2022,Malta,Venezuela,0,1,Friendly,Malta,1,-1
3529,6/1/2022,Scotland,Ukraine,1,3,World Cup qualifier,Scotland,1,-2
3530,6/1/2022,Poland,Wales,2,1,European Nations League A,Poland,1,1
3531,6/2/2022,Japan,Paraguay,4,1,Friendly,Japan,1,3
3532,6/2/2022,South Korea,Brazil,1,5,Friendly,South Korea,1,-4
3533,6/2/2022,Cambodia,East Timor,2,1,Friendly,Cambodia,1,1
3534,6/2/2022,Ecuador,Nigeria,1,0,Friendly,United States,0,1
3535,6/2/2022,Tunisia,Equatorial Guinea,4,0,African Nations Cup qualifier,Tunisia,1,4
3536,6/2/2022,Mozambique,Rwanda,1,1,African Nations Cup qualifier,South Africa,0,0
3537,6/2/2022,Panama,Costa Rica,2,0,CONCACAF Nations League A,Panama,1,2
3538,6/2/2022,French Guiana,Guatemala,2,0,CONCACAF Nations League B,French Guiana,1,2
3539,6/2/2022,Uruguay,Mexico,3,0,Friendly,United States,0,3
3540,6/2/2022,Antigua and Barbuda,Barbados,1,0,CONCACAF Nations League B,Saint Lucia,0,1
3541,6/2/2022,Anguilla,Dominica,0,0,CONCACAF Nations League C,Anguilla,1,0
3542,6/2/2022,Guadeloupe,Cuba,2,1,CONCACAF Nations League B,Guadeloupe,1,1
3543,6/2/2022,Belize,Dominican Republic,0,2,CONCACAF Nations League B,Belize,1,-2
3544,6/2/2022,Northern Ireland,Greece,0,1,European Nations League C,Northern Ireland,1,-1
3545,6/2/2022,Czechia,Switzerland,2,1,European Nations League A,Czechia,1,1
3546,6/2/2022,Slovenia,Sweden,0,2,European Nations League B,Slovenia,1,-2
3547,6/2/2022,Serbia,Norway,0,1,European Nations League B,Serbia,1,-1
3548,6/2/2022,Estonia,San Marino,2,0,European Nations League D,Estonia,1,2
3549,6/2/2022,Spain,Portugal,1,1,European Nations League A,Spain,1,0
3550,6/2/2022,Bulgaria,North Macedonia,1,1,European Nations League C,Bulgaria,1,0
3551,6/2/2022,Israel,Iceland,2,2,European Nations League B,Israel,1,0
3552,6/2/2022,Cyprus,Kosovo,0,2,European Nations League C,Cyprus,1,-2
3553,6/2/2022,Georgia,Gibraltar,4,0,European Nations League C,Georgia,1,4
3554,6/3/2022,Oman,Nepal,2,0,Friendly,Qatar,0,2
3555,6/3/2022,Ivory Coast,Zambia,3,1,African Nations Cup qualifier,Ivory Coast,1,2
3556,6/3/2022,Togo,Eswatini,2,2,African Nations Cup qualifier,Togo,1,0
3557,6/3/2022,Burkina Faso,Cape Verde,2,0,African Nations Cup qualifier,Morocco,0,2
3558,6/3/2022,Comoros,Lesotho,2,0,African Nations Cup qualifier,Comoros,1,2
3559,6/3/2022,Aruba,Saint Martin,0,0,CONCACAF Nations League C,Anguilla,0,0
3560,6/3/2022,Curaçao,Honduras,0,1,CONCACAF Nations League A,Curaçao,1,-1
3561,6/3/2022,Nicaragua,Trinidad and Tobago,2,1,CONCACAF Nations League B,Nicaragua,1,1
3562,6/3/2022,Bahamas,St Vincent & Grenadines,1,0,CONCACAF Nations League B,Bahamas,1,1
3563,6/3/2022,British Virgin Islands,Cayman Islands,1,1,CONCACAF Nations League C,British Virgin Islands,1,0
3564,6/3/2022,Sint Maarten,US Virgin Islands,1,1,CONCACAF Nations League C,Curaçao,0,0
3565,6/3/2022,Turks and Caicos Islands,Bonaire,1,4,CONCACAF Nations League C,Turks and Caicos Islands,1,-3
3566,6/3/2022,Croatia,Austria,0,3,European Nations League A,Croatia,1,-3
3567,6/3/2022,Belgium,Netherlands,1,4,European Nations League A,Belgium,1,-3
3568,6/3/2022,France,Denmark,1,2,European Nations League A,France,1,-1
3569,6/3/2022,Latvia,Andorra,3,0,European Nations League D,Latvia,1,3
3570,6/3/2022,Slovakia,Belarus,1,0,European Nations League C,Serbia,0,1
3571,6/3/2022,Liechtenstein,Moldova,0,2,European Nations League D,Liechtenstein,1,-2
3572,6/3/2022,Kazakhstan,Azerbaijan,2,0,European Nations League C,Kazakhstan,1,2
3573,6/4/2022,Algeria,Uganda,2,0,African Nations Cup qualifier,Algeria,1,2
3574,6/4/2022,Niger,Tanzania,1,1,African Nations Cup qualifier,Benin,0,0
3575,6/4/2022,DR Congo,Gabon,0,1,African Nations Cup qualifier,DR Congo,1,-1
3576,6/4/2022,Gambia,South Sudan,1,0,African Nations Cup qualifier,Senegal,0,1
3577,6/4/2022,Burundi,Namibia,1,1,African Nations Cup qualifier,South Africa,0,0
3578,6/4/2022,Mauritania,Sudan,3,0,African Nations Cup qualifier,Mauritania,1,3
3579,6/4/2022,Senegal,Benin,3,1,African Nations Cup qualifier,Senegal,1,2
3580,6/4/2022,Mali,Congo,4,0,African Nations Cup qualifier,Mali,1,4
3581,6/4/2022,El Salvador,Grenada,3,1,CONCACAF Nations League A,El Salvador,1,2
3582,6/4/2022,Bermuda,Haiti,0,0,CONCACAF Nations League B,Bermuda,1,0
3583,6/4/2022,Suriname,Jamaica,1,1,CONCACAF Nations League A,Suriname,1,0
3584,6/4/2022,Guyana,Montserrat,2,1,CONCACAF Nations League B,Dominican Republic,0,1
3585,6/4/2022,Hungary,England,1,0,European Nations League A,Hungary,1,1
3586,6/4/2022,Italy,Germany,1,1,European Nations League A,Italy,1,0
3587,6/4/2022,Finland,Bosnia and Herzegovina,1,1,European Nations League B,Finland,1,0
3588,6/4/2022,Lithuania,Luxembourg,0,2,European Nations League C,Lithuania,1,-2
3589,6/4/2022,Montenegro,Romania,2,0,European Nations League B,Montenegro,1,2
3590,6/4/2022,Turkey,Faroe Islands,4,0,European Nations League C,Turkey,1,4
3591,6/4/2022,Armenia,Ireland,1,0,European Nations League B,Armenia,1,1
3592,6/5/2022,Colombia,Saudi Arabia,1,0,Friendly,Spain,0,1
3593,6/5/2022,Egypt,Guinea,1,0,African Nations Cup qualifier,Egypt,1,1
3594,6/5/2022,Madagascar,Angola,1,1,African Nations Cup qualifier,Madagascar,1,0
3595,6/5/2022,Malawi,Ethiopia,2,1,African Nations Cup qualifier,Malawi,1,1
3596,6/5/2022,Central African Republic,Ghana,1,1,African Nations Cup qualifier,Angola,0,0
3597,6/5/2022,Botswana,Tunisia,0,0,African Nations Cup qualifier,Botswana,1,0
3598,6/5/2022,United States,Uruguay,0,0,Friendly,United States,1,0
3599,6/5/2022,Costa Rica,Martinique,2,0,CONCACAF Nations League A,Costa Rica,1,2
3600,6/5/2022,Guatemala,Belize,2,0,CONCACAF Nations League B,Guatemala,1,2
3601,6/5/2022,Ecuador,Mexico,0,0,Friendly,United States,0,0
3602,6/5/2022,Cuba,Barbados,3,0,CONCACAF Nations League B,Cuba,1,3
3603,6/5/2022,Anguilla,Dominica,1,1,CONCACAF Nations League C,Saint Kitts and Nevis,0,0
3604,6/5/2022,Antigua and Barbuda,Guadeloupe,1,0,CONCACAF Nations League B,Saint Kitts and Nevis,0,1
3605,6/5/2022,Dominican Republic,French Guiana,2,3,CONCACAF Nations League B,Dominican Republic,1,-1
3606,6/5/2022,Argentina,Estonia,5,0,Friendly,Spain,0,5
3607,6/5/2022,Peru,New Zealand,1,0,Friendly,Spain,0,1
3608,6/5/2022,Wales,Ukraine,1,0,World Cup qualifier,Wales,1,1
3609,6/5/2022,Cyprus,Northern Ireland,0,0,European Nations League C,Cyprus,1,0
3610,6/5/2022,Portugal,Switzerland,4,0,European Nations League A,Portugal,1,4
3611,6/5/2022,Sweden,Norway,1,2,European Nations League B,Sweden,1,-1
3612,6/5/2022,Czechia,Spain,2,2,European Nations League A,Czechia,1,0
3613,6/5/2022,Bulgaria,Georgia,2,5,European Nations League C,Bulgaria,1,-3
3614,6/5/2022,Kosovo,Greece,0,1,European Nations League C,Kosovo,1,-1
3615,6/5/2022,Serbia,Slovenia,4,1,European Nations League B,Serbia,1,3
3616,6/5/2022,San Marino,Malta,0,2,European Nations League D,San Marino,1,-2
3617,6/5/2022,Gibraltar,North Macedonia,0,2,European Nations League C,Gibraltar,1,-2
3618,6/6/2022,Japan,Brazil,0,1,Friendly,Japan,1,-1
3619,6/6/2022,South Korea,Chile,2,0,Friendly,South Korea,1,2
3620,6/6/2022,Equatorial Guinea,Libya,2,0,African Nations Cup qualifier,Equatorial Guinea,1,2
3621,6/6/2022,Aruba,Saint Martin,3,0,CONCACAF Nations League C,Curaçao,0,3
3622,6/6/2022,Honduras,Curaçao,1,2,CONCACAF Nations League A,Honduras,1,-1
3623,6/6/2022,Trinidad and Tobago,Bahamas,1,0,CONCACAF Nations League B,Trinidad and Tobago,1,1
3624,6/6/2022,St Vincent & Grenadines,Nicaragua,2,2,CONCACAF Nations League B,St Vincent & Grenadines,1,0
3625,6/6/2022,Cayman Islands,British Virgin Islands,1,1,CONCACAF Nations League C,Cayman Islands,1,0
3626,6/6/2022,Bonaire,Sint Maarten,2,2,CONCACAF Nations League C,Curaçao,0,0
3627,6/6/2022,US Virgin Islands,Turks and Caicos Islands,3,2,CONCACAF Nations League C,US Virgin Islands,1,1
3628,6/6/2022,Austria,Denmark,1,2,European Nations League A,Austria,1,-1
3629,6/6/2022,Croatia,France,1,1,European Nations League A,Croatia,1,0
3630,6/6/2022,Latvia,Liechtenstein,1,0,European Nations League D,Latvia,1,1
3631,6/6/2022,Azerbaijan,Belarus,0,0,European Nations League C,Serbia,0,0
3632,6/6/2022,Slovakia,Kazakhstan,0,1,European Nations League C,Slovakia,1,-1
3633,6/6/2022,Iceland,Albania,1,1,European Nations League B,Iceland,1,0
3634,6/6/2022,Andorra,Moldova,0,0,European Nations League D,Andorra,1,0
3635,6/7/2022,Australia,United Arab Emirates,2,1,World Cup qualifier,Qatar,0,1
3636,6/7/2022,Zambia,Comoros,2,1,African Nations Cup qualifier,Zambia,1,1
3637,6/7/2022,Cape Verde,Togo,2,0,African Nations Cup qualifier,Morocco,0,2
3638,6/7/2022,Burkina Faso,Eswatini,3,1,African Nations Cup qualifier,South Africa,0,2
3639,6/7/2022,Senegal,Rwanda,1,0,African Nations Cup qualifier,Senegal,1,1
3640,6/7/2022,Grenada,El Salvador,2,2,CONCACAF Nations League A,Grenada,1,0
3641,6/7/2022,Haiti,Montserrat,3,2,CONCACAF Nations League B,Dominican Republic,0,1
3642,6/7/2022,Jamaica,Suriname,3,1,CONCACAF Nations League A,Jamaica,1,2
3643,6/7/2022,Guyana,Bermuda,2,1,CONCACAF Nations League B,Guyana,1,1
3644,6/7/2022,Germany,England,1,1,European Nations League A,Germany,1,0
3645,6/7/2022,Italy,Hungary,2,1,European Nations League A,Italy,1,1
3646,6/7/2022,Finland,Montenegro,2,0,European Nations League B,Finland,1,2
3647,6/7/2022,Faroe Islands,Luxembourg,0,1,European Nations League C,Faroe Islands,1,-1
3648,6/7/2022,Bosnia and Herzegovina,Romania,1,0,European Nations League B,Bosnia and Herzegovina,1,1
3649,6/7/2022,Lithuania,Turkey,0,6,European Nations League C,Lithuania,1,-6
3650,6/8/2022,Philippines,Yemen,0,0,Asian Cup qualifier,Mongolia,0,0
3651,6/8/2022,Kuwait,Indonesia,1,2,Asian Cup qualifier,Kuwait,1,-1
3652,6/8/2022,India,Cambodia,2,0,Asian Cup qualifier,India,1,2
3653,6/8/2022,Hong Kong,Afghanistan,2,1,Asian Cup qualifier,India,0,1
3654,6/8/2022,Mongolia,Palestine,0,1,Asian Cup qualifier,Mongolia,1,-1
3655,6/8/2022,Tajikistan,Myanmar,4,0,Asian Cup qualifier,Kyrgyzstan,0,4
3656,6/8/2022,Uzbekistan,Sri Lanka,3,0,Asian Cup qualifier,Uzbekistan,1,3
3657,6/8/2022,Kyrgyzstan,Singapore,2,1,Asian Cup qualifier,Kyrgyzstan,1,1
3658,6/8/2022,Malaysia,Turkmenistan,3,1,Asian Cup qualifier,Malaysia,1,2
3659,6/8/2022,Thailand,Maldives,3,0,Asian Cup qualifier,Uzbekistan,0,3
3660,6/8/2022,Jordan,Nepal,2,0,Asian Cup qualifier,Kuwait,0,2
3661,6/8/2022,Bahrain,Bangladesh,2,0,Asian Cup qualifier,Malaysia,0,2
3662,6/8/2022,Uganda,Niger,1,1,African Nations Cup qualifier,Uganda,1,0
3663,6/8/2022,Tanzania,Algeria,0,2,African Nations Cup qualifier,Tanzania,1,-2
3664,6/8/2022,Sudan,DR Congo,2,1,African Nations Cup qualifier,Sudan,1,1
3665,6/8/2022,Congo,Gambia,1,0,African Nations Cup qualifier,Congo,1,1
3666,6/8/2022,Benin,Mozambique,0,1,African Nations Cup qualifier,Benin,1,-1
3667,6/8/2022,Gabon,Mauritania,0,0,African Nations Cup qualifier,Gabon,1,0
3668,6/8/2022,Scotland,Armenia,2,0,European Nations League B,Scotland,1,2
3669,6/8/2022,Wales,Netherlands,1,2,European Nations League A,Wales,1,-1
3670,6/8/2022,Belgium,Poland,6,1,European Nations League A,Belgium,1,5
3671,6/8/2022,Ireland,Ukraine,0,1,European Nations League B,Ireland,1,-1
3672,6/9/2022,Venezuela,Saudi Arabia,1,0,Friendly,Spain,0,1
3673,6/9/2022,New Zealand,Oman,0,0,Friendly,Qatar,0,0
3674,6/9/2022,Ethiopia,Egypt,2,0,African Nations Cup qualifier,Malawi,0,2
3675,6/9/2022,Morocco,South Africa,2,1,African Nations Cup qualifier,Morocco,1,1
3676,6/9/2022,Nigeria,Sierra Leone,2,1,African Nations Cup qualifier,Nigeria,1,1
3677,6/9/2022,Guinea-Bissau,São Tomé and Príncipe,5,1,African Nations Cup qualifier,Morocco,0,4
3678,6/9/2022,Cameroon,Burundi,1,0,African Nations Cup qualifier,Tanzania,0,1
3679,6/9/2022,Guinea,Malawi,1,0,African Nations Cup qualifier,Guinea,1,1
3680,6/9/2022,Mali,South Sudan,3,1,African Nations Cup qualifier,Uganda,0,2
3681,6/9/2022,Ivory Coast,Lesotho,0,0,African Nations Cup qualifier,South Africa,0,0
3682,6/9/2022,Canada,Curaçao,4,0,CONCACAF Nations League A,Canada,1,4
3683,6/9/2022,Aruba,Saint Kitts and Nevis,2,3,CONCACAF Nations League C,Curaçao,0,-1
3684,6/9/2022,Barbados,Guadeloupe,0,1,CONCACAF Nations League B,Saint Lucia,0,-1
3685,6/9/2022,Panama,Martinique,5,0,CONCACAF Nations League A,Panama,1,5
3686,6/9/2022,Dominica,Saint Lucia,0,1,CONCACAF Nations League C,Dominica,1,-1
3687,6/9/2022,Cuba,Antigua and Barbuda,2,0,CONCACAF Nations League B,Saint Kitts and Nevis,0,2
3688,6/9/2022,Belize,French Guiana,1,1,CONCACAF Nations League B,Belize,1,0
3689,6/9/2022,Cayman Islands,Puerto Rico,0,3,CONCACAF Nations League C,Cayman Islands,1,-3
3690,6/9/2022,Kosovo,Northern Ireland,3,2,European Nations League C,Kosovo,1,1
3691,6/9/2022,Switzerland,Spain,0,1,European Nations League A,Switzerland,1,-1
3692,6/9/2022,Sweden,Serbia,0,1,European Nations League B,Sweden,1,-1
3693,6/9/2022,Norway,Slovenia,0,0,European Nations League B,Norway,1,0
3694,6/9/2022,Malta,Estonia,1,2,European Nations League D,Malta,1,-1
3695,6/9/2022,Portugal,Czechia,2,0,European Nations League A,Portugal,1,2
3696,6/9/2022,Gibraltar,Bulgaria,1,1,European Nations League C,Gibraltar,1,0
3697,6/9/2022,Greece,Cyprus,3,0,European Nations League C,Greece,1,3
3698,6/9/2022,San Marino,Iceland,0,1,Friendly,San Marino,1,-1
3699,6/9/2022,North Macedonia,Georgia,0,3,European Nations League C,North Macedonia,1,-3
3700,6/10/2022,Japan,Ghana,4,1,Friendly tournament,Japan,1,3
3701,6/10/2022,South Korea,Paraguay,2,2,Friendly,South Korea,1,0
3702,6/10/2022,Tunisia,Chile,2,0,Friendly tournament,Japan,0,2
3703,6/10/2022,United States,Grenada,5,0,CONCACAF Nations League A,United States,1,5
3704,6/10/2022,Dominican Republic,Guatemala,1,1,CONCACAF Nations League B,Dominican Republic,1,0
3705,6/10/2022,St Vincent & Grenadines,Trinidad and Tobago,0,2,CONCACAF Nations League B,St Vincent & Grenadines,1,-2
3706,6/10/2022,Bahamas,Nicaragua,0,2,CONCACAF Nations League B,Bahamas,1,-2
3707,6/10/2022,Austria,France,1,1,European Nations League A,Austria,1,0
3708,6/10/2022,Denmark,Croatia,0,1,European Nations League A,Denmark,1,-1
3709,6/10/2022,Moldova,Latvia,2,4,European Nations League D,Moldova,1,-2
3710,6/10/2022,Belarus,Kazakhstan,1,1,European Nations League C,Serbia,0,0
3711,6/10/2022,Albania,Israel,1,2,European Nations League B,Albania,1,-1
3712,6/10/2022,Azerbaijan,Slovakia,0,1,European Nations League C,Azerbaijan,1,-1
3713,6/10/2022,Andorra,Liechtenstein,2,1,European Nations League D,Andorra,1,1
3714,6/11/2022,Mongolia,Philippines,0,1,Asian Cup qualifier,Mongolia,1,-1
3715,6/11/2022,Jordan,Indonesia,1,0,Asian Cup qualifier,Kuwait,0,1
3716,6/11/2022,India,Afghanistan,2,1,Asian Cup qualifier,India,1,1
3717,6/11/2022,Kyrgyzstan,Myanmar,2,0,Asian Cup qualifier,Kyrgyzstan,1,2
3718,6/11/2022,Thailand,Sri Lanka,2,0,Asian Cup qualifier,Uzbekistan,0,2
3719,6/11/2022,Hong Kong,Cambodia,3,0,Asian Cup qualifier,India,0,3
3720,6/11/2022,Tajikistan,Singapore,1,0,Asian Cup qualifier,Kyrgyzstan,0,1
3721,6/11/2022,Malaysia,Bahrain,1,2,Asian Cup qualifier,Malaysia,1,-1
3722,6/11/2022,Kuwait,Nepal,4,1,Asian Cup qualifier,Kuwait,1,3
3723,6/11/2022,Palestine,Yemen,5,0,Asian Cup qualifier,Mongolia,0,5
3724,6/11/2022,Turkmenistan,Bangladesh,2,1,Asian Cup qualifier,Malaysia,0,1
3725,6/11/2022,Uzbekistan,Maldives,4,0,Asian Cup qualifier,Uzbekistan,1,4
3726,6/11/2022,Ecuador,Cape Verde,1,0,Friendly,United States,0,1
3727,6/11/2022,Mexico,Suriname,3,0,CONCACAF Nations League A,Mexico,1,3
3728,6/11/2022,Guyana,Haiti,2,6,CONCACAF Nations League B,Guyana,1,-4
3729,6/11/2022,Uruguay,Panama,5,0,Friendly,Uruguay,1,5
3730,6/11/2022,Montserrat,Bermuda,3,2,CONCACAF Nations League B,Dominican Republic,0,1
3731,6/11/2022,Sint Maarten,Turks and Caicos Islands,8,2,CONCACAF Nations League C,Curaçao,0,6
3732,6/11/2022,US Virgin Islands,Bonaire,0,2,CONCACAF Nations League C,US Virgin Islands,1,-2
3733,6/11/2022,Ireland,Scotland,3,0,European Nations League B,Ireland,1,3
3734,6/11/2022,England,Italy,0,0,European Nations League A,England,1,0
3735,6/11/2022,Wales,Belgium,1,1,European Nations League A,Wales,1,0
3736,6/11/2022,Hungary,Germany,1,1,European Nations League A,Hungary,1,0
3737,6/11/2022,Netherlands,Poland,2,2,European Nations League A,Netherlands,1,0
3738,6/11/2022,Romania,Finland,1,0,European Nations League B,Romania,1,1
3739,6/11/2022,Luxembourg,Turkey,0,2,European Nations League C,Luxembourg,1,-2
3740,6/11/2022,Faroe Islands,Lithuania,2,1,European Nations League C,Faroe Islands,1,1
3741,6/11/2022,Ukraine,Armenia,3,0,European Nations League B,Poland,0,3
3742,6/11/2022,Montenegro,Bosnia and Herzegovina,1,1,European Nations League B,Montenegro,1,0
3743,6/12/2022,Algeria,Iran,2,1,Friendly,Qatar,0,1
3744,6/12/2022,Guadeloupe,Barbados,2,1,CONCACAF Nations League B,Guadeloupe,1,1
3745,6/12/2022,Martinique,Panama,0,0,CONCACAF Nations League A,Martinique,1,0
3746,6/12/2022,Cuba,Antigua and Barbuda,3,1,CONCACAF Nations League B,Cuba,1,2
3747,6/12/2022,Saint Lucia,Anguilla,2,0,CONCACAF Nations League C,Saint Lucia,1,2
3748,6/12/2022,Saint Kitts and Nevis,Saint Martin,1,1,CONCACAF Nations League C,Saint Kitts and Nevis,1,0
3749,6/12/2022,Puerto Rico,British Virgin Islands,6,0,CONCACAF Nations League C,Puerto Rico,1,6
3750,6/12/2022,Northern Ireland,Cyprus,2,2,European Nations League C,Northern Ireland,1,0
3751,6/12/2022,Switzerland,Portugal,1,0,European Nations League A,Switzerland,1,1
3752,6/12/2022,Norway,Sweden,3,2,European Nations League B,Norway,1,1
3753,6/12/2022,Spain,Czechia,2,0,European Nations League A,Spain,1,2
3754,6/12/2022,Georgia,Bulgaria,0,0,European Nations League C,Georgia,1,0
3755,6/12/2022,Greece,Kosovo,2,0,European Nations League C,Greece,1,2
3756,6/12/2022,Slovenia,Serbia,2,2,European Nations League B,Slovenia,1,0
3757,6/12/2022,Malta,San Marino,1,0,European Nations League D,Malta,1,1
3758,6/12/2022,North Macedonia,Gibraltar,4,0,European Nations League C,North Macedonia,1,4
3759,6/13/2022,Australia,Peru,0,0,World Cup qualifier,Qatar,0,0
3760,6/13/2022,Guinea-Bissau,Sierra Leone,2,2,African Nations Cup qualifier,Guinea,0,0
3761,6/13/2022,Nigeria,São Tomé and Príncipe,10,0,African Nations Cup qualifier,Morocco,0,10
3762,6/13/2022,Morocco,Liberia,2,0,African Nations Cup qualifier,Morocco,1,2
3763,6/13/2022,Honduras,Canada,2,1,CONCACAF Nations League A,Honduras,1,1
3764,6/13/2022,Guatemala,Dominican Republic,2,0,CONCACAF Nations League B,Guatemala,1,2
3765,6/13/2022,Trinidad and Tobago,St Vincent & Grenadines,4,1,CONCACAF Nations League B,Trinidad and Tobago,1,3
3766,6/13/2022,Nicaragua,Bahamas,4,0,CONCACAF Nations League B,Nicaragua,1,4
3767,6/13/2022,Denmark,Austria,2,0,European Nations League A,Denmark,1,2
3768,6/13/2022,France,Croatia,0,1,European Nations League A,France,1,-1
3769,6/13/2022,Albania,Estonia,0,0,Friendly,Albania,1,0
3770,6/13/2022,Azerbaijan,Belarus,2,0,European Nations League C,Azerbaijan,1,2
3771,6/13/2022,Iceland,Israel,2,2,European Nations League B,Iceland,1,0
3772,6/13/2022,Kazakhstan,Slovakia,2,1,European Nations League C,Kazakhstan,1,1
3773,6/14/2022,Japan,Tunisia,0,3,Friendly tournament,Japan,1,-3
3774,6/14/2022,Palestine,Philippines,4,0,Asian Cup qualifier,Mongolia,0,4
3775,6/14/2022,Indonesia,Nepal,7,0,Asian Cup qualifier,Kuwait,0,7
3776,6/14/2022,India,Hong Kong,4,0,Asian Cup qualifier,India,1,4
3777,6/14/2022,Afghanistan,Cambodia,2,2,Asian Cup qualifier,India,0,0
3778,6/14/2022,Mongolia,Yemen,2,0,Asian Cup qualifier,Mongolia,1,2
3779,6/14/2022,South Korea,Egypt,4,1,Friendly,South Korea,1,3
3780,6/14/2022,Singapore,Myanmar,6,2,Asian Cup qualifier,Kyrgyzstan,0,4
3781,6/14/2022,Maldives,Sri Lanka,1,0,Asian Cup qualifier,Uzbekistan,0,1
3782,6/14/2022,Malaysia,Bangladesh,4,1,Asian Cup qualifier,Malaysia,1,3
3783,6/14/2022,Uzbekistan,Thailand,2,0,Asian Cup qualifier,Uzbekistan,1,2
3784,6/14/2022,Kyrgyzstan,Tajikistan,0,0,Asian Cup qualifier,Kyrgyzstan,1,0
3785,6/14/2022,Kuwait,Jordan,0,3,Asian Cup qualifier,Kuwait,1,-3
3786,6/14/2022,Bahrain,Turkmenistan,1,0,Asian Cup qualifier,Malaysia,0,1
3787,6/14/2022,Chile,Ghana,0,0,Friendly tournament,Japan,0,0
3788,6/14/2022,El Salvador,United States,1,1,CONCACAF Nations League A,El Salvador,1,0
3789,6/14/2022,Costa Rica,New Zealand,1,0,World Cup qualifier,Qatar,0,1
3790,6/14/2022,Jamaica,Mexico,1,1,CONCACAF Nations League A,Jamaica,1,0
3791,6/14/2022,Haiti,Guyana,6,0,CONCACAF Nations League B,Dominican Republic,0,6
3792,6/14/2022,French Guiana,Belize,1,0,CONCACAF Nations League B,French Guiana,1,1
3793,6/14/2022,Turks and Caicos Islands,Sint Maarten,2,0,CONCACAF Nations League C,Turks and Caicos Islands,1,2
3794,6/14/2022,Bonaire,US Virgin Islands,2,0,CONCACAF Nations League C,Curaçao,0,2
3795,6/14/2022,Armenia,Scotland,1,4,European Nations League B,Armenia,1,-3
3796,6/14/2022,England,Hungary,0,4,European Nations League A,England,1,-4
3797,6/14/2022,Netherlands,Wales,3,2,European Nations League A,Netherlands,1,1
3798,6/14/2022,Poland,Belgium,0,1,European Nations League A,Poland,1,-1
3799,6/14/2022,Germany,Italy,5,2,European Nations League A,Germany,1,3
3800,6/14/2022,Bosnia and Herzegovina,Finland,3,2,European Nations League B,Bosnia and Herzegovina,1,1
3801,6/14/2022,Luxembourg,Faroe Islands,2,2,European Nations League C,Luxembourg,1,0
3802,6/14/2022,Romania,Montenegro,0,3,European Nations League B,Romania,1,-3
3803,6/14/2022,Liechtenstein,Latvia,0,2,European Nations League D,Liechtenstein,1,-2
3804,6/14/2022,Turkey,Lithuania,2,0,European Nations League C,Turkey,1,2
3805,6/14/2022,Ireland,Ukraine,1,1,European Nations League B,Poland,0,0
3806,6/14/2022,Moldova,Andorra,2,1,European Nations League D,Moldova,1,1
3807,7/5/2022,Botswana,Seychelles,1,0,COSAFA Cup,South Africa,0,1
3808,7/5/2022,Angola,Comoros,3,1,COSAFA Cup,South Africa,0,2
3809,7/6/2022,Eswatini,Mauritius,3,0,COSAFA Cup,South Africa,0,3
3810,7/6/2022,Lesotho,Malawi,2,1,COSAFA Cup,South Africa,0,1
3811,7/7/2022,Botswana,Comoros,1,0,COSAFA Cup,South Africa,0,1
3812,7/7/2022,Angola,Seychelles,3,0,COSAFA Cup,South Africa,0,3
3813,7/8/2022,Lesotho,Mauritius,2,1,COSAFA Cup,South Africa,0,1
3814,7/8/2022,Eswatini,Malawi,1,1,COSAFA Cup,South Africa,0,0
3815,7/10/2022,Malawi,Mauritius,2,0,COSAFA Cup,South Africa,0,2
3816,7/10/2022,Eswatini,Lesotho,2,0,COSAFA Cup,South Africa,0,2
3817,7/10/2022,Botswana,Angola,1,0,COSAFA Cup,South Africa,0,1
3818,7/10/2022,Comoros,Seychelles,2,1,COSAFA Cup,South Africa,0,1
3819,7/12/2022,Botswana,Zambia,1,1,COSAFA Cup,South Africa,0,0
3820,7/12/2022,Namibia,Madagascar,2,0,COSAFA Cup,South Africa,0,2
3821,7/13/2022,South Africa,Mozambique,0,0,COSAFA Cup,South Africa,1,0
3822,7/13/2022,Eswatini,Senegal,1,1,COSAFA Cup,South Africa,0,0
3823,7/15/2022,South Africa,Madagascar,2,1,COSAFA Cup,South Africa,1,1
3824,7/15/2022,Zambia,Senegal,4,3,COSAFA Cup,South Africa,0,1
3825,7/15/2022,Botswana,Eswatini,2,0,COSAFA Cup,South Africa,0,2
3826,7/15/2022,Namibia,Mozambique,1,0,COSAFA Cup,South Africa,0,1
3827,7/16/2022,Philippines,East Timor,4,1,Friendly,Indonesia,0,3
3828,7/17/2022,South Africa,Botswana,2,1,COSAFA Cup,South Africa,1,1
3829,7/17/2022,Zambia,Namibia,1,0,COSAFA Cup,South Africa,0,1
3830,7/17/2022,Mozambique,Senegal,1,1,COSAFA Cup,South Africa,0,0
3831,7/18/2022,Mauritius,Seychelles,2,0,Friendly,Mauritius,1,2
3832,7/19/2022,Japan,Hong Kong,6,0,East Asian Championship,Japan,1,6
3833,7/20/2022,South Korea,China,3,0,East Asian Championship,Japan,0,3
3834,7/24/2022,Japan,China,0,0,East Asian Championship,Japan,1,0
3835,7/24/2022,South Korea,Hong Kong,3,0,East Asian Championship,Japan,0,3
3836,7/27/2022,Japan,South Korea,3,0,East Asian Championship,Japan,1,3
3837,7/27/2022,China,Hong Kong,1,0,East Asian Championship,Japan,0,1
3838,8/26/2022,Jamaica,Qatar,1,1,Friendly tournament,Austria,0,0
3839,8/31/2022,Paraguay,Mexico,1,0,Friendly,United States,0,1
3840,9/17/2022,Fiji,New Caledonia,1,0,Melanesian Cup,Vanuatu,0,1
3841,9/21/2022,Vietnam,Singapore,4,0,Friendly tournament,Vietnam,1,4
3842,9/21/2022,Hong Kong,Myanmar,2,0,Friendly,Hong Kong,1,2
3843,9/21/2022,Brunei,Maldives,0,3,Friendly tournament,Brunei,1,-3
3844,9/21/2022,Libya,Uganda,0,0,Friendly tournament,Libya,1,0
3845,9/21/2022,Morocco,Madagascar,1,0,Friendly,Morocco,1,1
3846,9/21/2022,San Marino,Seychelles,0,0,Friendly,San Marino,1,0
3847,9/21/2022,Solomon Islands,New Caledonia,1,0,Melanesian Cup,Vanuatu,0,1
3848,9/21/2022,Scotland,Ukraine,3,0,European Nations League B,Scotland,1,3
3849,9/22/2022,Australia,New Zealand,1,0,Friendly,Australia,1,1
3850,9/22/2022,Thailand,Malaysia,1,1,King's Cup,Thailand,1,0
3851,9/22/2022,Cambodia,Bangladesh,0,1,Friendly,Cambodia,1,-1
3852,9/22/2022,Tajikistan,Trinidad and Tobago,2,1,King's Cup,Thailand,0,1
3853,9/22/2022,Tunisia,Comoros,1,0,Friendly,France,0,1
3854,9/22/2022,Suriname,Nicaragua,2,1,Friendly,Netherlands,0,1
3855,9/22/2022,Iceland,Venezuela,1,0,Friendly,Austria,0,1
3856,9/22/2022,Belgium,Wales,2,1,European Nations League A,Belgium,1,1
3857,9/22/2022,France,Austria,2,0,European Nations League A,France,1,2
3858,9/22/2022,Poland,Netherlands,0,2,European Nations League A,Poland,1,-2
3859,9/22/2022,Turkey,Luxembourg,3,3,European Nations League C,Turkey,1,0
3860,9/22/2022,Croatia,Denmark,2,1,European Nations League A,Croatia,1,1
3861,9/22/2022,Latvia,Moldova,1,2,European Nations League D,Latvia,1,-1
3862,9/22/2022,Lithuania,Faroe Islands,1,1,European Nations League C,Lithuania,1,0
3863,9/22/2022,Kazakhstan,Belarus,2,1,European Nations League C,Kazakhstan,1,1
3864,9/22/2022,Slovakia,Azerbaijan,1,2,European Nations League C,Slovakia,1,-1
3865,9/22/2022,Liechtenstein,Andorra,0,2,European Nations League D,Liechtenstein,1,-2
3866,9/23/2022,Japan,United States,2,0,Friendly,Germany,0,2
3867,9/23/2022,Iran,Uruguay,1,0,Friendly,Austria,0,1
3868,9/23/2022,South Korea,Costa Rica,2,2,Friendly,South Korea,1,0
3869,9/23/2022,Jordan,Syria,2,0,Friendly tournament,Jordan,1,2
3870,9/23/2022,Iraq,Oman,1,1,Friendly tournament,Jordan,0,0
3871,9/23/2022,Ecuador,Saudi Arabia,0,0,Friendly,Spain,0,0
3872,9/23/2022,Bahrain,Cape Verde,1,2,Friendly,Bahrain,1,-1
3873,9/23/2022,Canada,Qatar,2,0,Friendly,Austria,0,2
3874,9/23/2022,Paraguay,United Arab Emirates,1,0,Friendly,Austria,0,1
3875,9/23/2022,Uzbekistan,Cameroon,2,0,Friendly,South Korea,0,2
3876,9/23/2022,Egypt,Niger,3,0,Friendly tournament,Egypt,1,3
3877,9/23/2022,Mali,Zambia,1,0,Friendly,Mali,1,1
3878,9/23/2022,Ethiopia,Sudan,1,1,Friendly,Ethiopia,1,0
3879,9/23/2022,Burkina Faso,DR Congo,1,0,Friendly,Morocco,0,1
3880,9/23/2022,Brazil,Ghana,3,0,Friendly,France,0,3
3881,9/23/2022,Morocco,Chile,2,0,Friendly,Spain,0,2
3882,9/23/2022,Algeria,Guinea,1,0,Friendly,Algeria,1,1
3883,9/23/2022,Equatorial Guinea,Rwanda,0,0,Friendly,Morocco,0,0
3884,9/23/2022,Argentina,Honduras,3,0,Friendly,United States,0,3
3885,9/23/2022,Italy,England,1,0,European Nations League A,Italy,1,1
3886,9/23/2022,Germany,Hungary,0,1,European Nations League A,Germany,1,-1
3887,9/23/2022,Finland,Romania,1,1,European Nations League B,Finland,1,0
3888,9/23/2022,Estonia,Malta,2,1,European Nations League D,Estonia,1,1
3889,9/23/2022,Bulgaria,Gibraltar,5,1,European Nations League C,Bulgaria,1,4
3890,9/23/2022,Bosnia and Herzegovina,Montenegro,1,0,European Nations League B,Bosnia and Herzegovina,1,1
3891,9/23/2022,Georgia,North Macedonia,2,0,European Nations League C,Georgia,1,2
3892,9/24/2022,Indonesia,Curaçao,3,2,Friendly,Indonesia,1,1
3893,9/24/2022,India,Singapore,1,1,Friendly tournament,Vietnam,0,0
3894,9/24/2022,Hong Kong,Myanmar,0,0,Friendly,Hong Kong,1,0
3895,9/24/2022,Kyrgyzstan,Russia,1,2,Friendly,Kyrgyzstan,1,-1
3896,9/24/2022,Maldives,Laos,3,1,Friendly tournament,Brunei,0,2
3897,9/24/2022,South Africa,Sierra Leone,4,0,Friendly,South Africa,1,4
3898,9/24/2022,Tanzania,Uganda,1,0,Friendly tournament,Libya,0,1
3899,9/24/2022,Congo,Madagascar,3,3,Friendly,Morocco,0,0
3900,9/24/2022,Martinique,Guinea-Bissau,1,1,Friendly,Martinique,1,0
3901,9/24/2022,Ivory Coast,Togo,2,1,Friendly,France,0,1
3902,9/24/2022,Mauritania,Benin,1,0,Friendly,Morocco,0,1
3903,9/24/2022,Senegal,Bolivia,2,0,Friendly,France,0,2
3904,9/24/2022,Colombia,Guatemala,4,1,Friendly,United States,0,3
3905,9/24/2022,Mexico,Peru,1,0,Friendly,United States,0,1
3906,9/24/2022,Grenada,St Vincent & Grenadines,1,3,Friendly,Grenada,1,-2
3907,9/24/2022,Vanuatu,Papua New Guinea,0,1,Melanesian Cup,Vanuatu,1,-1
3908,9/24/2022,Fiji,Solomon Islands,2,2,Melanesian Cup,Vanuatu,0,0
3909,9/24/2022,Scotland,Ireland,2,1,European Nations League B,Scotland,1,1
3910,9/24/2022,Northern Ireland,Kosovo,2,1,European Nations League C,Northern Ireland,1,1
3911,9/24/2022,Spain,Switzerland,1,2,European Nations League A,Spain,1,-1
3912,9/24/2022,Serbia,Sweden,4,1,European Nations League B,Serbia,1,3
3913,9/24/2022,Slovenia,Norway,2,1,European Nations League B,Slovenia,1,1
3914,9/24/2022,Czechia,Portugal,0,4,European Nations League A,Czechia,1,-4
3915,9/24/2022,Armenia,Ukraine,0,5,European Nations League B,Armenia,1,-5
3916,9/24/2022,Cyprus,Greece,1,0,European Nations League C,Cyprus,1,1
3917,9/24/2022,Israel,Albania,2,1,European Nations League B,Israel,1,1
3918,9/25/2022,New Zealand,Australia,0,2,Friendly,New Zealand,1,-2
3919,9/25/2022,Malaysia,Tajikistan,0,0,King's Cup,Thailand,0,0
3920,9/25/2022,Thailand,Trinidad and Tobago,2,1,King's Cup,Thailand,1,1
3921,9/25/2022,Liberia,Niger,0,0,Friendly tournament,Egypt,0,0
3922,9/25/2022,Wales,Poland,0,1,European Nations League A,Wales,1,-1
3923,9/25/2022,Austria,Croatia,1,3,European Nations League A,Austria,1,-2
3924,9/25/2022,Netherlands,Belgium,1,0,European Nations League A,Netherlands,1,1
3925,9/25/2022,Denmark,France,2,0,European Nations League A,Denmark,1,2
3926,9/25/2022,Luxembourg,Lithuania,1,0,European Nations League C,Luxembourg,1,1
3927,9/25/2022,Andorra,Latvia,1,1,European Nations League D,Andorra,1,0
3928,9/25/2022,Faroe Islands,Turkey,2,1,European Nations League C,Faroe Islands,1,1
3929,9/25/2022,Slovakia,Belarus,1,1,European Nations League C,Slovakia,1,0
3930,9/25/2022,Moldova,Liechtenstein,2,0,European Nations League D,Moldova,1,2
3931,9/25/2022,Azerbaijan,Kazakhstan,3,0,European Nations League C,Azerbaijan,1,3
3932,9/26/2022,Iraq,Syria,1,0,Friendly tournament,Jordan,0,1
3933,9/26/2022,Jordan,Oman,1,0,Friendly tournament,Jordan,1,1
3934,9/26/2022,Mali,Zambia,0,0,Friendly,Mali,1,0
3935,9/26/2022,Ethiopia,Sudan,2,2,Friendly,Ethiopia,1,0
3936,9/26/2022,England,Germany,3,3,European Nations League A,England,1,0
3937,9/26/2022,Hungary,Italy,0,2,European Nations League A,Hungary,1,-2
3938,9/26/2022,Montenegro,Finland,0,2,European Nations League B,Montenegro,1,-2
3939,9/26/2022,San Marino,Estonia,0,4,European Nations League D,San Marino,1,-4
3940,9/26/2022,Romania,Bosnia and Herzegovina,4,1,European Nations League B,Romania,1,3
3941,9/26/2022,North Macedonia,Bulgaria,0,1,European Nations League C,North Macedonia,1,-1
3942,9/26/2022,Gibraltar,Georgia,1,2,European Nations League C,Gibraltar,1,-1
3943,9/27/2022,Ecuador,Japan,0,0,Friendly,Germany,0,0
3944,9/27/2022,Indonesia,Curaçao,2,1,Friendly,Indonesia,1,1
3945,9/27/2022,Vietnam,India,3,0,Friendly tournament,Vietnam,1,3
3946,9/27/2022,Iran,Senegal,1,1,Friendly,Austria,0,0
3947,9/27/2022,South Korea,Cameroon,1,0,Friendly,South Korea,1,1
3948,9/27/2022,Brunei,Laos,1,0,Friendly tournament,Brunei,1,1
3949,9/27/2022,Saudi Arabia,United States,0,0,Friendly,Spain,0,0
3950,9/27/2022,Bahrain,Panama,0,2,Friendly,Bahrain,1,-2
3951,9/27/2022,Chile,Qatar,2,2,Friendly,Austria,0,0
3952,9/27/2022,Venezuela,United Arab Emirates,4,0,Friendly,Austria,0,4
3953,9/27/2022,Nepal,Bangladesh,3,1,Friendly,Nepal,1,2
3954,9/27/2022,Costa Rica,Uzbekistan,2,1,Friendly,South Korea,0,1
3955,9/27/2022,Egypt,Liberia,3,0,Friendly tournament,Egypt,1,3
3956,9/27/2022,South Africa,Botswana,1,0,Friendly,South Africa,1,1
3957,9/27/2022,Libya,Tanzania,2,1,Friendly tournament,Libya,1,1
3958,9/27/2022,Madagascar,Benin,3,1,Friendly,Morocco,0,2
3959,9/27/2022,DR Congo,Sierra Leone,3,0,Friendly,Morocco,0,3
3960,9/27/2022,Algeria,Nigeria,2,1,Friendly,Algeria,1,1
3961,9/27/2022,Ghana,Nicaragua,1,0,Friendly,Spain,0,1
3962,9/27/2022,Equatorial Guinea,Togo,2,2,Friendly,Morocco,0,0
3963,9/27/2022,Brazil,Tunisia,5,1,Friendly,France,0,4
3964,9/27/2022,Morocco,Paraguay,0,0,Friendly,Spain,0,0
3965,9/27/2022,Burkina Faso,Comoros,2,1,Friendly,Morocco,0,1
3966,9/27/2022,Ivory Coast,Guinea,3,1,Friendly,France,0,2
3967,9/27/2022,Mauritania,Congo,2,0,Friendly,Morocco,0,2
3968,9/27/2022,Uruguay,Canada,2,0,Friendly,Slovakia,0,2
3969,9/27/2022,Peru,El Salvador,4,1,Friendly,United States,0,3
3970,9/27/2022,Honduras,Guatemala,2,1,Friendly,United States,0,1
3971,9/27/2022,Colombia,Mexico,3,2,Friendly,United States,0,1
3972,9/27/2022,Argentina,Jamaica,3,0,Friendly,United States,0,3
3973,9/27/2022,Papua New Guinea,Fiji,1,0,Melanesian Cup,Vanuatu,0,1
3974,9/27/2022,Scotland,Ukraine,0,0,European Nations League B,Poland,0,0
3975,9/27/2022,Greece,Northern Ireland,3,1,European Nations League C,Greece,1,2
3976,9/27/2022,Switzerland,Czechia,2,1,European Nations League A,Switzerland,1,1
3977,9/27/2022,Sweden,Slovenia,1,1,European Nations League B,Sweden,1,0
3978,9/27/2022,Norway,Serbia,0,2,European Nations League B,Norway,1,-2
3979,9/27/2022,Portugal,Spain,0,1,European Nations League A,Portugal,1,-1
3980,9/27/2022,Ireland,Armenia,3,2,European Nations League B,Ireland,1,1
3981,9/27/2022,Malta,Israel,2,1,Friendly,Malta,1,1
3982,9/27/2022,Albania,Iceland,1,1,European Nations League B,Albania,1,0
3983,9/27/2022,Kosovo,Cyprus,5,1,European Nations League C,Kosovo,1,4
3984,9/30/2022,Fiji,Solomon Islands,1,0,Melanesian Cup,Vanuatu,0,1
3985,10/1/2022,St Vincent & Grenadines,Grenada,1,5,Friendly,St Vincent & Grenadines,1,-4
3986,10/13/2022,Qatar,Nicaragua,2,1,Friendly,Spain,0,1
3987,10/22/2022,Saudi Arabia,North Macedonia,1,0,Friendly,United Arab Emirates,0,1
3988,10/23/2022,Qatar,Guatemala,2,0,Friendly,Spain,0,2
3989,10/26/2022,Albania,Saudi Arabia,1,1,Friendly,United Arab Emirates,0,0
3990,10/27/2022,Qatar,Honduras,1,0,Friendly,Spain,0,1
3991,10/30/2022,Honduras,Saudi Arabia,0,0,Friendly,United Arab Emirates,0,0
3992,11/5/2022,Qatar,Panama,2,1,Friendly,Spain,0,1
3993,11/5/2022,Brunei,East Timor,6,2,Southeast Asian Champ qual,Brunei,1,4
3994,11/6/2022,Saudi Arabia,Iceland,1,0,Friendly,United Arab Emirates,0,1
3995,11/8/2022,Brunei,East Timor,0,1,Southeast Asian Champ qual,Brunei,1,-1
3996,11/9/2022,Mexico,Iraq,4,0,Friendly,Spain,0,4
3997,11/9/2022,Qatar,Albania,1,0,Friendly,Spain,0,1
3998,11/9/2022,Costa Rica,Nigeria,2,0,Friendly,Costa Rica,1,2
3999,11/9/2022,Cameroon,Jamaica,1,1,Friendly,Cameroon,1,0
4000,11/10/2022,Iran,Nicaragua,1,0,Friendly,Iran,1,1
4001,11/10/2022,Panama,Saudi Arabia,1,1,Friendly,United Arab Emirates,0,0
4002,11/11/2022,South Korea,Iceland,1,0,Friendly,South Korea,1,1
4003,11/11/2022,Bahrain,Canada,2,2,Friendly,Bahrain,1,0
4004,11/12/2022,Ecuador,Iraq,0,0,Friendly,Spain,0,0
4005,11/15/2022,Dominican Republic,Cuba,2,4,Friendly,Dominican Republic,1,-2
4006,11/15/2022,Panama,Venezuela,2,2,Friendly,United Arab Emirates,0,0
4007,11/16/2022,Tunisia,Iran,2,0,Friendly,Qatar,0,2
4008,11/16/2022,Nepal,Pakistan,1,0,Friendly,Nepal,1,1
4009,11/16/2022,Saudi Arabia,Croatia,0,1,Friendly,Saudi Arabia,1,-1
4010,11/16/2022,Oman,Germany,0,1,Friendly,Oman,1,-1
4011,11/16/2022,United Arab Emirates,Argentina,0,5,Friendly,United Arab Emirates,1,-5
4012,11/16/2022,Uzbekistan,Kazakhstan,2,0,Friendly,Uzbekistan,1,2
4013,11/16/2022,Ivory Coast,Burundi,4,0,Friendly,Morocco,0,4
4014,11/16/2022,Algeria,Mali,1,1,Friendly,Algeria,1,0
4015,11/16/2022,Nicaragua,El Salvador,1,0,Friendly,Nicaragua,1,1
4016,11/16/2022,Sweden,Mexico,2,1,Friendly,Spain,0,1
4017,11/16/2022,Poland,Chile,1,0,Friendly,Poland,1,1
4018,11/16/2022,Peru,Paraguay,1,0,Friendly,Peru,1,1
4019,11/16/2022,Turkey,Scotland,2,1,Friendly,Turkey,1,1
4020,11/16/2022,Austria,Andorra,1,0,Friendly,Spain,0,1
4021,11/16/2022,Albania,Italy,1,3,Friendly,Albania,1,-2
4022,11/16/2022,Latvia,Estonia,1,1,Baltic Cup,Latvia,1,0
4023,11/16/2022,Lithuania,Iceland,0,0,Baltic Cup,Lithuania,1,0
4024,11/16/2022,Cyprus,Bulgaria,0,2,Friendly,Cyprus,1,-2
4025,11/16/2022,Moldova,Azerbaijan,1,2,Friendly,Moldova,1,-1
4026,11/16/2022,Czechia,Faroe Islands,5,0,Friendly,Czechia,1,5
4027,11/16/2022,Kosovo,Armenia,2,2,Friendly,Kosovo,1,0
4028,11/16/2022,Gibraltar,Liechtenstein,2,0,Friendly,Gibraltar,1,2
4029,11/17/2022,Canada,Japan,2,1,Friendly,United Arab Emirates,0,1
4030,11/17/2022,Belarus,Syria,1,0,Friendly,United Arab Emirates,0,1
4031,11/17/2022,Jordan,Spain,1,3,Friendly,Jordan,1,-2
4032,11/17/2022,Tajikistan,Russia,0,0,Friendly,Tajikistan,1,0
4033,11/17/2022,South Africa,Mozambique,2,1,Friendly,South Africa,1,1
4034,11/17/2022,Israel,Zambia,4,2,Friendly,Israel,1,2
4035,11/17/2022,Portugal,Nigeria,4,0,Friendly,Portugal,1,4
4036,11/17/2022,Ghana,Switzerland,2,0,Friendly,United Arab Emirates,0,2
4037,11/17/2022,Gabon,Guinea-Bissau,3,1,Friendly,Turkey,0,2
4038,11/17/2022,Rwanda,Sudan,0,0,Friendly,Rwanda,1,0
4039,11/17/2022,Libya,Niger,3,2,Friendly,Turkey,0,1
4040,11/17/2022,Morocco,Georgia,3,0,Friendly,United Arab Emirates,0,3
4041,11/17/2022,Angola,Botswana,1,0,Friendly,South Africa,0,1
4042,11/17/2022,Saint Lucia,San Marino,1,1,Friendly,Saint Lucia,1,0
4043,11/17/2022,Luxembourg,Hungary,2,2,Friendly,Luxembourg,1,0
4044,11/17/2022,Ireland,Norway,1,2,Friendly,Ireland,1,-1
4045,11/17/2022,North Macedonia,Finland,1,1,Friendly,North Macedonia,1,0
4046,11/17/2022,Romania,Slovenia,1,2,Friendly,Romania,1,-1
4047,11/17/2022,Malta,Greece,2,2,Friendly,Malta,1,0
4048,11/17/2022,Montenegro,Slovakia,2,2,Friendly,Montenegro,1,0
4049,11/18/2022,Bahrain,Serbia,1,5,Friendly,Bahrain,1,-4
4050,11/18/2022,Egypt,Belgium,2,1,Friendly,Kuwait,0,1
4051,11/18/2022,Cameroon,Panama,1,1,Friendly,United Arab Emirates,0,0
4052,11/18/2022,Dominican Republic,Cuba,1,1,Friendly,Dominican Republic,1,0
4053,11/19/2022,Kuwait,Lebanon,2,0,Friendly,United Arab Emirates,0,2
4054,11/19/2022,United Arab Emirates,Kazakhstan,2,1,Friendly,United Arab Emirates,1,1
4055,11/19/2022,Rwanda,Sudan,1,0,Friendly,Rwanda,1,1
4056,11/19/2022,Burkina Faso,Ivory Coast,2,1,Friendly,Morocco,0,1
4057,11/19/2022,Sweden,Algeria,2,0,Friendly,Sweden,1,2
4058,11/19/2022,Guatemala,Nicaragua,3,1,Friendly,United States,0,2
4059,11/19/2022,Suriname,French Guiana,1,3,Friendly,Suriname,1,-2
4060,11/19/2022,Colombia,Paraguay,2,0,Friendly,United States,0,2
4061,11/19/2022,Peru,Bolivia,1,0,Friendly,Peru,1,1
4062,11/19/2022,Estonia,Lithuania,2,0,Baltic Cup,Estonia,1,2
4063,11/19/2022,Latvia,Iceland,1,1,Baltic Cup,Latvia,1,0
4064,11/19/2022,Turkey,Czechia,2,1,Friendly,Turkey,1,1
4065,11/19/2022,Albania,Armenia,2,0,Friendly,Albania,1,2
4066,11/19/2022,Kosovo,Faroe Islands,1,1,Friendly,Kosovo,1,0
4067,11/19/2022,Gibraltar,Andorra,1,0,Friendly,Gibraltar,1,1
4068,11/20/2022,Venezuela,Syria,2,1,Friendly,United Arab Emirates,0,1
4069,11/20/2022,Oman,Belarus,2,0,Friendly,United Arab Emirates,0,2
